ChangePassword=パスワードを変更する
ChangePasswordForm=パスワード変更フォーム
ConfirmNewPassword=新しいパスワードの確認
CreateAccount=アカウントを作成
CurrentPassword=現在のパスワード
DoNotHaveAccount=アカウントをお持ちでない場合は、
Email=メール
EnterPasswordAndEmail=メールアドレスとパスワードを入力してくログインしてください。
ErrorCheck=あなたは、いくつかのフォームのエラーを持っている。以下にご確認ください。
ForgotPassword=パスワードを忘れた
KeepSignedIn=ログインしたままにする
Login=ログイン
MinimumLengthForPassword={0}、少なくとも{2}文字でなければなりません。
NewPassword=新しいパスワード
NewPasswordConfirmationPasswordDoNoMatch=新しいパスワードと確認パスワードが一致しません。
Password=パスワード
SignInAccount=あなたのアカウントにログイン
TitleOfLogin=VCM{YODA}ログイン - ベータ
UserNamePasswordIncorrect=提供されたユーザー名またはパスワードが正しくありません。
UseUpToDateVersion=最新のブラウザをお使いください：
AuthenticationReturnError=認証プロバイダがエラーを返しました。入力内容を確認して、もう一度お試しください。問題が解決しない場合は、システム管理者に連絡してください。
EmailExist=その電子メールアドレスのユーザ名が既に存在する。別の電子メールアドレスを入力してください。
EmailInvaild=提供の電子メールアドレスが無効です。値をチェックして、もう一度お試しください。
InvalidAccess=無効なアクセス
LoginRemoved=外部ログインを除去した。
PasswordChanged=パスワードが変更されました。
PasswordIncorrect=現在のパスワードが間違っているか、新しいパスワードが無効です。
PasswordInvalid=提供されたパスワードは無効です。有効なパスワード値を入力してください。
PasswordRetrievalAnswerInvalid=提供されたパスワードの取得の答えは無効です。値をチェックして、もう一度お試しください。
PasswordRetrivalQuestionInvalid=提供されたパスワードの取得の問題が無効です。値をチェックして、もう一度お試しください。
PasswordSet=パスワードが設定されている。
RequestCanceled=ユーザー作成要求はキャンセルされました。入力内容を確認して、もう一度お試しください。問題が解決しない場合は、システム管理者に連絡してください。
UnknownError=不明なエラーが発生しました。入力内容を確認して、もう一度お試しください。問題が解決しない場合は、システム管理者に連絡してください。
UserNameExist=ローカルアカウントを作成することができません。名前のアカウント\\"{0}\\"は既に存在してもよい。
UserNameExist1=ユーザー名は既に存在します。別のユーザー名を入力してください。
UserNameInvalid=提供されたユーザー名が無効です。値をチェックして、もう一度お試しください。
ChameleonVCMLogin=カメレオンVCMログイン
CurrentOrNewPasswordInvalid=現在のパスワードが間違っているか、新しいパスワードが無効です。
EnterEmailToResetPassword=あなたのパスワードをリセットするには、以下の電子メールアドレスを入力してください。
ErrorAndCheck=あなたは、いくつかのフォームのエラーを持っている。以下にご確認ください。
FillInEmail=電子メールアドレスをご記入ください。
FillInPassword=パスワードを入力してください
FillInValidEmail=有効なメールアドレスを記入してください
ForgotPassword1=パスワードをお忘れですか？
IllegalAccess=不正アクセス
NewPasswordFilled=新しいパスワードが入力されているはずです。
NotAvailable={0}は使用できません
NoUserNameUnderSubsite=このユーザー名とのユーザーは、このサブサイトの下にはありません
NoUserUnderSubsite=どのユーザーも、このサブサイトの下にはありません
ResetPassword=あなたのパスワードをリセット
ResetPasswordTokenExpired=パスワードのリセットトークンの有効期限が切れています。パスワードは変更されません。
SignInByEmail=メールアドレスでログイン
SignInByUserName=ユーザー名によるサインイン
ImpersonateUser=ユーザーを偽装
Impersonating=身分を偽った投稿
ListOfSubsites=サブサイトのリスト
ListOfUsers=ユーザーの一覧
UserNameContains=ユーザー名が含まれています
ChooseSubsite=Please choose a subsite
Impersonate=Impersonate
InputUserName=Please input user name
StopImpersonating=Stop Impersonating