AbilityUploadPdf=PDFをアップロードして電子書籍に変換する機能
Activate=有効にする
Activated=有効
Active=有効
AddItem=アセットを追加
AddRateCard=料金表を追加
AddTemplate=テンプレートを追加
AndMobile=とモバイル
AndPhone=と電話
Approved=承認済み
BuyPrice=購入価格
BuzCollectionCode=Buzコレクションコード
BuzPriceMarkup=Buz価格値上げ
BuzPricePercentage=Buz価格の割合
BuzProductCode=Buz製品コード
ByActivatingTemplate=テンプレートを有効にすると、使用できる状態になります。
ByDeActivatingTemplate=テンプレートを無効にすると、使用できない状態になります。
CannotSelectedAtSameTime=同時に選択することはできません。
ChameleonSentInvoice=Chameleon Marketing Solutionsは請求書を送付しました - 請求書
ClickCharge=クリックチャージ
ConvertPrintUIPDF=Print UIのInDesign PDFを電子書籍に変換
CopyOf=コピー
CopyTemplateAcrossSite=サイト全体にこテンプレートをコピー
CopyTemplateHere=テンプレートをコピー
CreateArtwork=アートワークを作成
CreateEBook=電子書籍の機能を設定
CustomizedItemType=カスタマイズされたアセットの種類
CustomizedSize=カスタマイズされたサイズ
DeActivate=無効にする
DeActivated=無効
DeleteSelectedTemplate=選択したテンプレートを削除
DeliveryCost=送料
Description=説明
DescriptionCharacterLimit=説明の文字数制限
Discount=割引
DonotSelect=選択しないでください。
EBook=電子書籍
EditArtwork=アートワークを編集
EditorType=エディターの種類
EditorVersion=エディターのバージョン
EditTemplate=テンプレートを編集
EDM=EDM
EmailFrom=メールの送信元
EmailSentFrom=メールは
EnableCreatePDF=PDFを2つの方法で作成することができます。
EnableManageEmailArtwork=メールのアートワークを管理することができます。
EnableManagePrintUITemplates=PrintUIのテンプレートを管理することができます。
EnableQuoteRequest=見積もり依頼を有効にする
EnablesManageMicrosites=マイクロサイトを管理することができます。
ExtraCost=追加費用
GenerateInvoice=請求書を生成
HowToCreatEbook=1 - PrintUIから電子書籍を作成する方法
HowToCreatEbook2=2 - PDFファイルをアップロードして電子書籍を作成する方法
HowToCreatEbook2Step1=ステップ1：「テンプレートを追加」ボタンをクリックします。
HowToCreatEbook2Step10=ステップ10：「戻る」をクリックして、「有効」をクリックしてテンプレートを使用できる状態にします。
HowToCreatEbook2Step2=ステップ2：エディターのバージョンをV5エディターにします。
HowToCreatEbook2Step3=ステップ3：タイプをE-Suiteにします。
HowToCreatEbook2Step4=ステップ4：サブタイプを電子書籍にします。
HowToCreatEbook2Step5=ステップ5：テンプレート名を入力します。
HowToCreatEbook2Step6=ステップ6：テンプレートの動作を「アップロード」にします。
HowToCreatEbook2Step7=ステップ7：必要な場合、承認方法を選択します。
HowToCreatEbook2Step8=ステップ8：保存先を右メニューのカテゴリから選択します。
HowToCreatEbook2Step9=ステップ9：「追加」をクリックしてください
HowToManageEmailArtwork=メールのアートワークを管理する方法
HowToManageMicrosites=マイクロサイトを管理する方法
HowToManagePrintUITemplates=PrintUIのテンプレートを管理する方法
HowToManageTemplate=テンプレートを管理する方法
HowToSetUpPrintUITemplate=PrintUIのテンプレートを設定する方法
ItemType=アセットのタイプ
ManageEmailArtwork=メールのアートワークを管理する
ManageEmailArtworkStep1=ステップ1：アセッット > テンプレートに移動します。
ManageEmailArtworkStep2=ステップ2：「/」を検索して、メールを探します。
ManageEmailArtworkStep3=ステップ3：「編集」ボタンをクリックします。
ManageEmailArtworkStep4=ステップ4：必要な場合、テンプレートを変更・更新します。
ManageEmailArtworkStep5=ステップ5：必要な場合、テンプレートのカテゴリマッピングを変更してください。
ManageEmailArtworkStep6=ステップ6：「更新」をクリックして、変更を保存します。
ManageEmailArtworkStep7=ステップ7：テンプレートは自由に有効・無効にすることができます。
ManageMicrosites=マイクロサイトを管理する
ManageMicrositeStep1=ステップ1：アセッット > テンプレートに移動します。
ManageMicrositeStep2=ステップ2：「/」を検索して、マイクロサイトを探します。
ManageMicrositeStep3=ステップ3：「編集」ボタンをクリックします。
ManageMicrositeStep4=ステップ4：必要な場合、テンプレートを変更・更新します。
ManageMicrositeStep5=ステップ5：必要な場合、テンプレートのカテゴリマッピングを変更してください。
ManageMicrositeStep6=ステップ6：「更新」をクリックして、変更を保存します。
ManageMicrositeStep7=ステップ7：テンプレートは自由に有効・無効にすることができます。
ManagePrintUITemplateStep1=ステップ1：エディターのバージョン > PrintUIに移動します。
ManagePrintUITemplateStep10=ステップ10：「追加」をクリックします。
ManagePrintUITemplateStep11=ステップ11：必要な場合、テンプレートに料金表を追加します。
ManagePrintUITemplateStep12=ステップ12：右側の「有効」ボタンをクリックして、テンプレートを有効にすることができます。
ManagePrintUITemplateStep2=ステップ2：エディターのタイプを選択します。
ManagePrintUITemplateStep21=フラッシュ：より柔軟性を持つフラッシュをベースにした編集可能なテンプレート。
ManagePrintUITemplateStep22=HTML：フラッシュに比べて柔軟性が低いフォームをベースにした編集可能なテンプレート。
ManagePrintUITemplateStep3=ステップ3：<b>テンプレート名</b>を入力します。
ManagePrintUITemplateStep4=ステップ4：オリジナルPDFファイルを基準としてアップロードします。
ManagePrintUITemplateStep5=ステップ5：必要な場合、クリックチャージを有効にします。
ManagePrintUITemplateStep6=ステップ6：必要な場合、承認過程を変更します。
ManagePrintUITemplateStep7=ステップ7：注文書の送信先を選択します。
ManagePrintUITemplateStep8=ステップ8：必要な場合、印刷管理の見積もり依頼を有効にします。
ManagePrintUITemplateStep9=ステップ9：保存先を右メニューのカテゴリから選択します。ManageTemplateNote=テンプレートを有効にすると使用できる状態になります。テンプレートを無効にするとサイトから非表示になります。
ManageTemplateStep1=ステップ1：エディターのタイプを選択します。
ManageTemplateStep10=ステップ10：「追加」をクリックします。
ManageTemplateStep2=ステップ2：アートワークの種類を選択します。
ManageTemplateStep3=ステップ3：テンプレート名を入力してください。
ManageTemplateStep4=ステップ4：オリジナルPDFファイルを基準としてアップロードします。
ManageTemplateStep5=ステップ5：必要な場合、クリックチャージを有効にします。
ManageTemplateStep6=ステップ6：必要な場合、承認過程を変更します。
ManageTemplateStep7=ステップ7：注文書の送信先を選択します。
ManageTemplateStep8=ステップ8：必要な場合、印刷管理の見積もり依頼を有効にします。
ManageTemplateStep9=ステップ9：保存先を右メニューのカテゴリから選択します。
MapAssetCategory=アセットがまだ保存されていません。アセットをマッピングして、カテゴリを一つ選択してください。
MicrositeStyle=マイクロサイトのスタイル
MISType=MIS型
NeedApproval=承認待ち
None=なし
OriginalPDFFile=オリジナルPDFファイル
OriginalPdfFileRequired=古いエディターでテンプレートの動作が動的でない場合、オリジナルPDFファイルが必要です。
Phone=電話
POSentFrom=注文書の送信元
Price=価格
PriceSchema=価格のスキーマ
Print=印刷
Publication=出版物
Quantity=数量
RateCardName=料金表の名前
Select=選択
SelectClientSite=クライアントサイトを選択
SelectEditorType=エディターのタイプを選択
SelectEditorVersion=エディターのバージョンを選択
SelectItemType=アセットタイプを選択
SelectMicrositeStyle=マイクロサイトのスタイルを選択
SelectNeedApproval=承認待ちを選択
SelectPOSentFrom=注文書の送信元を選択
SelectSize=サイズを選択
SelectSubType=サブタイプを選択
SelectTemplateItemSize=テンプレートのアセットサイズを選択
SelectTemplateItemType=テンプレートのアセットタイプを選択
SelectTemplateSubtype=テンプレートのサブタイプを選択
SelectTemplateType=テンプレートのタイプを選択
SelectType=タイプの選択
SendInvoice=テンプレートに適用請求書を選択
SettingUpTemplateRules=テンプレートルールを設定します。
SetupCost=セットアップ費用
ShowPropertySmartForm=物件のスマートフォームを表示
Size=サイズ
Specifications=仕様書
SpecificationsName=仕様の名前
SpecificationsValue=仕様値
Status=ステータス
Step1=ステップ1：検索してPrintUIのテンプレートを選択します。
Step2=ステップ2：「編集」をクリックします。
Step3=ステップ3：テンプレートの動作を 「電子書籍が有効になっている」にしてください。
SubType=サブタイプ
SureDeleteCheckedTemplates=確認済みのテンプレートを削除してもよろしいですか？
SureRemoveItem=アセットを削除してもよろしいですか？
TemplateAddPage=TemplateAddPage
TemplateBehaviours=テンプレートの動作
TemplateEditPage=TemplateEditPage
TemplateList=テンプレート一覧
TemplateListPage=テンプレート一覧画面
TemplateMappingRequired=テンプレートの作成、またはマッピングが必要
TemplateName=テンプレート名
TotalNumber=総数：
Type=タイプ
Undefined=未定義
UpdateRateCard=料金表を更新
UpdatingTemplate=テンプレートを更新
ViewAndRespond=表示して返答する
WaitingClientApproval=クライアントからのテンプレート承認待ち
WaitingTemplateCreated=テンプレートの作成待ち
Website=ウェブサイト
WithEmailAddress=メールアドレスと
AddEditRateCard=料金表を追加・編集
LastUpdatedBy=最終更新者
LastUpdatedDate=最終更新日
MappedRatecards=マップされた料金表
PriceSpecification=価格仕様
TemplatePreview=テンプレートのプレビュー
AddNewRateCard=新しい料金表を追加
CCEmailList=CCのメールリスト
CCEmailListDesc=CCのメールリスト
CompanyName=会社名
EditRateCard=料金表を編集
ExistingCompanyFound=企業が既に存在します
PreviousInvoice=過去の請求書
PreviousInvoiceSentDate=過去の請求書の送信日
RateCard=料金表
SelectMISType=MIS型を選択
TemplateCreationPrice=テンプレート作成の価格
TemplateCreationPriceExclGst=テンプレート作成の価格(税抜)
TemplateId=テンプレートID
TemplateInvoice=請求書のテンプレート
TemplateInvoicePage=TemplateInvoicePage
TemplateRateCardPage=TemplateRateCardPage
TemplateSelectSiteErrorPage=TemplateSelectSiteErrorPage
FillInCompanyName=会社名を入力してください。
TemplateDetails=テンプレートの詳細
AddColourPalette=カラーパレットを追加
AddEditColourPalette=カラーパレットを追加・編集
Colour=カラー
ColourPalette=カラーパレット
EditColourPalette=カラーパレットを編集
FifthAttribute=属性５
FirstAttribute=属性１
FouthAttribute=属性４
MappedColourPalette=マップされたカラーパレット
SecondAttribute=属性２
SelectColourPalette=カラーパレットを選択
TemplateColourPalette=カラーパレットのテンプレート
ThirdAttribute=属性３
HeadlineCharacterLimit=見出しの文字数制限