AddOptionalQuestion=任意の質問を追加
AddQuestion=質問を追加
AnswerOption=回答の選択肢
AnswerType=回答の種類
AssetCustomForm=カスタムフォーム
CreateCustomForm=カスタムフォームの作成
CreateForm=フォームの作成
CreateFormStep2=ステップ2：属するサブサイトを選択します。
CreateFormStep3=ステップ3：カスタムフォームの番号を選択します。一つのサブサイトに対してカスタムフォームは最大二つまで選択可能です。
CreateFormStep4=ステップ4：カスタムフォームのタイトルを入力します。タイトルは公開サイトの左側のメニューに表示されます。
CreateFormStep5=ステップ5：カスタムフォームの名前と説明を入力します。
CreateFormStep6=ステップ6：カスタムフォームの通知を受信する方のメールアドレス（複数可）を入力します。
CreateFormStep7=ステップ7：質問を回答を追加して設定を保存します。
CustomForm1=カスタムフォーム1
CustomForm2=カスタムフォーム2
CustomFormDescription=カスタムフォームの説明
CustomFormName=カスタムフォーム名
CustomFormNumber=カスタムフォームの番号
CustomFormNumberIncorrect=カスタムフォームの番号が正しくありません。
CustomForms=カスタムフォーム
CustomFormTitle=カスタムフォームのタイトル
DefaultAnswer=デフォルト回答
DeleteForm=このカスタムフォームを削除してもよろしいですか？
DeleteForms=選択したカスタムフォームを削除
DelimeterExample=区切り文字 - 例えば 1;2;3
DescOfCreateForm=カスタムアートワークオーダー、マーケティング資料のお問い合わせフォーム、商品の注文などを自由にお問い合わせ用のフォームを追加できます。
EditCustomForm=カスタムフォームを編集
ForAnonymous=匿名
FormIdInvalid=無効なカスタムフォームID
HowToCreateForm=カスタムフォームの作成方法
Id=ID
ImportantNote=注意事項：
Mandatory=必須
Maximum=最大
Minimum=最小
NoFormCreated=カスタムフォームが作成されませんでしてた！
NoQuestionsCreated=質問が作成されていません！質問を入力して、再度をお試しください。
NoteDesc=第三者のデジタル資産管理システムとのインテグ方法については、システム管理者にご連絡ください。
NotifyTo=メール通知
NumberOnly=数字だけ入力してください。
Numeric=数字
OptionalFor=任意項目
OptionalForAnswer=任意の回答
Question=質問
SelectCustomFormNumber=カスタムフォームの番号を選択してください。
SelectCustomFormNumber1=カスタムフォームの番号を選択
SelectSubsite=サブサイトを選択してください。
Sequence=登録方法
Step1=ステップ1：「作成」ボタンをクリックします。
Step2=ステップ2：カスタムフォームの名前と説明を入力します。
Step3=ステップ3：カスタムフォームの通知を受信する方のメールアドレス（複数可）を入力します。
Step4=ステップ4：質問と回答を追加して設定を保存します。