AddFile=ファイルを追加
AssetCategoryMap=アセットがまだ保存されていません。アセットをマッピングして、カテゴリを一つ選択してください。
AssetImage=画像
Change=変更
CreateBulk=バッチを作成
CreateImage=画像を作成
DeleteCheckedImages=確認済み画像を削除してもよろしいですか？
DeleteImage=選択した画像を削除
DescOfManageImage=アップロードした画像を管理します。アップロードされた画像がポータル上で閲覧し、テンプレートに適用することができます。
EditImage=画像を編集
ExpiryDate=有効期限
HowToManageImages=画像の管理・アップロード方法
Id=ID
ImageInvalid=エラー：画像を読み取れませんでした。
ImageList=画像一覧
ImageName=画像名
ImageUrl=画像のURL
ImportantNote=注意事項：
ManageImages=アップロードした画像を管理する
MaximumUpload=バッチアップロードの最大容量の50MBを超えました。容量を減らし、もう一度試してください。
NoteDesc=第三者のデジタル資産管理システムとのインテグ方法については、システム管理者にご連絡してください。開発費用の見積もりを送付します。
OriginalImageFile=オリジナル画像ファイル
Remove=削除
Selectfile=ファイルを選択
Step1=ステップ1：「アップロード」ボタンをクリックします。
Step2=ステップ2：有効期限がある場合日付けを選択します。
Step3=ステップ3：画像名を入力します。
Step4=ステップ4：画像ファイルをアップロードします。
Step5=ステップ5：「+ファイルを追加」をクリックして複数ファイルを同時にアップロードすることもできます。
Step6=ステップ6：保存先のカテゴリを選択します。
Step7=ステップ7：アップロードをクリックします。
SureDeleteImage=画像を削除してもよろしいですか？
Thumbnail=サムネイル
TotalNumber=総数：
UploadImages=画像をアップロード