AddBudget=予算を追加
Admin=管理者
AfterHours=アフター・アワーズ
Announcements=お知らせ
BoardingRequest=あなたが搭乗要求に{0}がある（S）
BoardingSites=あなたが搭乗サイト上の{0}がある（S）
BudgetMustBeNumeric=予算は数値でなければなりません。
BudgetReport=予算レポート
By=バイ
CartsApprovedOrRejected={0}のカートが承認または拒否されている
CartsWaitingForApproval={0}のカートがあなたの承認を待っている
Contact=転落先
ContinueWithoutSelectProperty=任意のプロパティを選択せずに続行
Dashboard=ダッシュボード
HomePage=ホームページ
InfoForStep1=顧客サイトを\r\nサブサイト管理右上のメニューから選ぶ
InfoForStep2=あなたの左のメニューオプションから選択してあなたのサイトを管理します。説示／ヘルプは、各ページで使用できます。
InformationForStep1=まず、会社の詳細を登録、サイトを作成することによって、本社サイトを作成します。
InformationForStep2=枝やフランチャイズのためのあなたのサブサイトを作成します。
InformationForStep3=顧客サイトの左メニューに表示されるカテゴリを設定します。
InformationForStep4=情報ウィンドウのプロンプトに従い、すべての手順を実行して、プロセスを設定サイトを続行します。
JobsApprovedOrRejected=承認または却下されたジョブが{0}あります
JobsWaitingForApproval=承認待ちのジョブが{0}あります
Main=メイン
ManageSite=既存のサイトの管理方法
ModifyTemplateToJumpStart=あなたのASP.NET MVCアプリケーションをジャンプスタートするには、このテンプレートを変更します。
NewsList=ニュース一覧
NewsListPage=NewsListPage
NotSelected=未選択
PropertyDetails=不動産の詳細
QuickHelp=何をすべきか援助やわからないが必要ですか？クイックヘルプをクリックします。
RejectedOriginalAsset=拒否されたオリジナル·アセット
RequestForOriginalAsset=アップロードオリジナルアセットのリクエスト
RequestWaitingForApproval=オリジナルアセットの承認待ちリクエスト
SelectAnotherProperty=別のプロパティを選択
SelectedSitename=選択したサイト名：
SelectProperty=Selectプロパティ
SetUpSite=新しいサイトを設定する方法
Step1=ステップ1：
Step2=ステップ2：
Step3=ステップ3：
Step4=ステップ4：
TitleOfAdmin=管理コンソールのダッシュボード
Updates=アップデート
UserHasNotAssigned=ユーザーがまだ指定されたサイトに割り当てられていない、plsは助けをカメレオンadministrtorにお問い合わせください。
ViewMore=もっと見る
WelcomeToAdmin=管理コンソールへようこそ
CampaignReport=キャンペーンレポート
LoginToSalesForce=画像をダウンロードするために、Salesforceへログイン
NoImagesFound=いいえ画像が見つかりませんでした
OrderReport=オーダーレポート
PleaseSelectProperty=プロパティを選択してください
ResultOf=結果
ResultsFor=の結果
SearchForPropertyAddress=物件アドレスを検索する
SearchImages=検索画像
SearchResultImage=検索結果画像
TemplateReport=テンプレートレポート