AddCompany=会社を追加
AddCompanyInfo=会社情報を追加
AddEditRateCard=追加/編集料金表
AddRateCard=料金表を追加
ChooseArtworkSupplier=アートワークサプライヤーを選択するか、元のPDFファイルをアップロードしてください。
ClientCompanyName=クライアント会社名
CompanyName=会社名
CompletionDate=完了日
CustomerOnBoarding=搭乗オンカスタマー
DonotSelect=選択しないでください
EmailRegistered=このメールはすでに登録されている、別のものをお選びください。
EnterCustomerName=顧客名や販売ノートに入力してください。
EnterRequiredFields=すべての必須フィールドを入力してください。
FillInClientCompanyName=クライアントの会社名をご記入ください。
FillInConfirmPassword=確認パスワードをご記入ください
FillInPassword=パスワードを入力してください。
FillInRejectionReason=拒否理由を記入してください。
FontNameMustFilled=フォント名を入力する必要があります
FontStyleMustFilled=フォントスタイルを埋めなければならない
InvalidEmail=無効な電子メール。電子メールが使用されてきた。
Login=ログイン
Next=次
NoOnBoardingInformation=このサブサイトについてのオンボーディング情報がありません
NoPermissionToAccess=あなたは、このクライアントにアクセスする権限がありません
NoSubsiteFound=ユーザーが見つかりませサブサイトません
OnBoardingRequestSent=会社名{0}のオンボーディング要望があなたに送信された
OnBoardingSalesStartPage=OnBoardingSalesStartPage
ParameterCannotNull=パラメータはnullにすることはできません。
PasswordMinimumCharacters=パスワードは少なくとも6文字でなければなりません。
PasswordSameWithConfirmPassword=必ずパスワードを作成し、パスワードを確認同じですしてください。
PleaseSelectTemplateSubType=テンプレートサブタイプを選択してください。
RequireAssitance=手伝いが必要であったりサイトの設定に関する質問があれば<br />サイトの管理者に連絡してください。<br /><br />
SalesNotes=セールスノート
SaveStartSiteSetup=保存＆サイトのセットアップを開始します
SelectCompanyToProceed=続行する会社を選択してください。
SelectOneSubsite=少なくとも1サブサイトを選択してください。
SelectTemplateItemSize=テンプレートアイテムのサイズを選択します
SelectTemplateItemType=テンプレートのアイテムの種類を選択します
SelectTemplateSubType=テンプレートサブタイプを選択
SelectTemplateType=テンプレートの種類を選択してください。
SiteRegistration=サイトの登録
SiteRegistrationCompleted=あなたのサイトの登録は完了です。あなたのサイトをセットアップするお進みください。
SiteRegistrationSent=サイト登録があなたに送信されました [ {0} ]
SubsiteIdIncorrect=サブサイトIDが正しくありません
TemporaryUserNamePassword=ユーザ名とパスワードを以下一時的に次回ログイン時にパスワードを変更してください、あなたのアカウントにログインできるようにするために作成されている。 <br /><br/>
TotalPrice=総価格
UpdateRateCard=更新料金表
UploadFontFile=フォントファイルをアップロードしてください。
UploadOriginalAsset=オリジナルアセットをアップロードしてください。
UploadProposal=プロポーザルをアップロード
UserCreated=ユーザーが作成した。
Username=ユーザー名
UserNameTaken=このユーザ名が取られている、別のものを選択してください。
ViewRegistration=登録を見るにはこちらをクリックしてください
ABN=ABN
AddFile=ファイルを追加
AddToStructure=構造化するために追加
ApprovalProcess=承認審査方式
ApprovalProcessRequired=承認プロセスが必要とされていますか？
BankMerchantOtherPaymentFacility=銀行商人/その他の支払い施設
BillingEmail=課金メール
BillingMobile=課金モバイル
BillingName=課金名
BillingPhone=課金電話
ChangeHierarchy=クリック + ホールドし、ドラッグアンドドロップしながら階層を変更します。
Completed=完成した
ContactEmail=連絡先メールアドレス
ContactMobile=連絡先携帯電話番号
ContactName=連絡先名
ContactPhone=連絡先電話番号
CreateSubsite=サブサイトを作成
CreateSubsites=サブサイトを作成
CreateYourSites=あなたのサイトを作成
CustomerWebsiteURL=顧客のウェブサイトのURLは
DescForApprovalAll=アートワークを承認する必要がありますセットアップするすべての承認者は次の段階に到達するためにユーザを有効にする
DescForApprovalAny=あなたが承認されている限り、承認者のいずれかがアートワーク/キャンペーン/カートを承認するよう承認者として設定し、複数のユーザーが、アートワークはマークされている必要があります。
DescForApprovalHierarchy=あなたのサブサイトは、承認プロセスは、階層の低いレベルで開始し、その後、その方法までチェーンを行います階層レベルに設定する必要があります。例えば、あなたは本社レベルおよび状態レベルを有していてもよい。承認者は、それぞれの状態に設定し、本社になります。たとえば、NSWのユーザーが、アートワークを作成する必要があり、NSWの承認者が承認依頼通知を受け取ります。 NSWの承認者がアートワークを承認した後、本社の承認者は、承認依頼通知を受け取ります。状態は承認者が何らかの理由でアートワークを拒否する必要があり、本社は、このいずれかの通知を受信しません。
DescOfApprovalProcess=最良のあなたのビジネスに最適すべてのアートワーク、注文やキャンペーンの承認プロセスを選択してください。これは後から変更することができます。
DescOfDetails=セットアップをしてもらいたいご希望の銀行や他の決済ゲートウェイの詳細を入力してください。<br />\r\n 要件と統合に関しての相談のためサイトの管理者からご連絡いたします。<br />\r\n 注意：承認の上開発コストがかかりうる。
DetailsForSiteSetup=検討し、サイトの設定のための顧客の詳細を調整してください。完成したら、SAVEをクリックして、電子メール通知が自分のサイトをセットアップするためにそれらを可能にするために顧客/クライアントに送信されます。別の方法としては、顧客に代わってサイトを設定することができます。
DoNotHaveCredentials=あなたがPrintUIの資格を持っていない場合は、サイト管理者までご連絡ください。
EmailForSiteSetup=連絡先メールは、彼らのサイトを設定することができ、電子メール要求を受信します。あなたがクライアントに連絡確保し、彼らがサイトのセットアップのためのメールが届きます教えてください。
EnterPrintUISettings=あなたがPrintUI設定を入力してください。
LeftMenuUnlocked=左側のメニューのロックが解除され、あなたは、管理、更新を編集、必要な場合任意のセクションにテンプレートを追加することができる。
NeedHelp=ヘルプが必要ですか？インストラクショナル·ウィンドウは、あなたが任意の助けが必要な場合、各ページで使用できます。また、左側のメニューのクイックヘルプボタンを参照することができます。
Notes=注釈
OfficeAddress=事務所住所
OnBoardingCompleted=オンボーディング完了
OnBoardingEntryEdit=搭乗エントリ編集上の
PasswordIs=パスワードは
PaymentGateway=支払いゲートウェイ
PaymentGatewayRequired=ペイメントゲートウェイは必要ですか？
PayPalMerchantAccountId=PayPalのマーチャントアカウントID
PayPalMerchantEmail=ペイパルマーチャントEメール
PleaseUploadProposal=利用可能な場合に承認販売提案のコピーをアップロードしてください。
PleaseUploadProposal1=提案書をアップロードしてください
PostalAddress=住所
PrintUIAuthorizationCode=PrintUI認証コード
PrintUIClientId=PrintUIクライアントID
PrintUiSettings=PrintUI設定
ProposalURL=プロポーザルのURL
SaveContinue=保存＆続行
SaveSendToCustomer=保存＆顧客に送る
SaveStartSiteSetup1=保存＆サイトのセットアップを開始します
SelectingAll=選択するすべての
SelectingHierarchy=選択する階層
SetupPaymentGateway=セットアップ支払いゲートウェイ
SetupWizard=セットアップウィザード
StartSearching=検索を開始する...
ThankYouForSettingUpSite=サイトを設定していただきありがとうございます。
TradingName=取引名
UserNameIs=ユーザー名は