AdditionalField=追加項目
AddOrUpdate=追加または更新
CannotBeSaved=保存することはできません。
ChooseLoginType=ログイン方法を選択してください。
CreateNewSite=新規サイトを登録
CreateSite=サイトを登録
Description=説明
Field=項目
FieldNameExists=項目名は既に存在します。
FieldRemoved='{0}'項目が正常に削除されました。
FieldSaved='{0}'項目が正常に保存されました。
InputValidSiteName=サイト名に有効な英数字を入力してください。
InvalidField=無効な項目
InvalidName=無効な名前
InvalidSite=無効なサイト
LoginType=ログイン方法
NewField=新規項目
NoSite=サイトが登録されていません。
SelectLoginType=ログイン方法を選択
SelectSettingCategory=カテゴリを選択
SettingCategories=カテゴリを設定
Settings=設定
SiteExists=サイトは既に存在します。別のサイト名を入力してください。
SiteID=サイトID
SiteList=サイト一覧
SiteSetting=サイトの設定
SpaceNotAllowed=サイト名にはスペースを使用しないでください。
UserAdditionalField=ユーザの追加項目
Value=値
SelectClientSite=公開サイトを選択
StopImpersonating=ログアウト