AgentId=エージェントID
BackToSubsiteList=サブサイトの一覧へ戻る
ChangeSubsiteName=サブサイト名とロゴ、テーマを変更
ChooseCRMType=CRMの種類を選択してください。
CompanyInvoice=会社の請求書
CompanyName=会社名
CreateSubsite=サブサイトを登録
CreateSubsiteDesc=このサブサイト直下にサブサイトを登録するには、ここをクリックしてください。
CRMType=CRMの種類
CurrentBrandLogo=現在のブランドロゴ
CurrentCoBrandingImage=現在の共通ブランド画像
CurrentEmailHeaderImage=現在のメールヘッダーの画像
CurrentHomeImage=現在のホームページの画像
FillInAgentId=エージェントIDを入力してください。
FillInCompanyName=会社名を入力してください。
FillInEmail=メールアドレスを入力してください。
HeaderEmailHeaderImage=メールヘッダーの画像
HeaderEmailHeaderImageTitle=システムから送信された全てのメールに表示されます。
HeaderHomeImage=ホームページの画像
HeaderHomeImageTitle=画面中央のホームページに表示されます
IllegalAccess=不正アクセス
IntroImages=オープニング画像
IntroText=オープニングテキスト
InvaidEmail=無効なメールアドレス
InvalidName=無効な名前
ManageSubsiteSettings=このサブサイトとそれ以下のサブサイトの設定を管理します。サブサイトに変更された内容は親サイトに反映されません。
NoSubsite=サブサイトは登録されていません。
OutroImages=エンディング画像
OutroText=エンディングテキスト
ParentSubsite=親サブサイト
Saved=保存されました
SelectClientSite=顧客サイトを選択してください。
SelectCRMType=CRMの種類を選択してください。
SelectSettingCategory=設定のカテゴリを選択
SettingCategories=設定のカテゴリ
SettingCompanyInvoice=会社の請求書を設定
SettingCRM=CRMを設定
SettingIntroOutroVideo=オープニングとエンディングビデオを設定
Settings=設定
SettingSubsiteCRM=サブサイトのCRMを設定
SubsiteList=サブサイト一覧
SubsiteName=サブサイト名
SubsiteSetting=サブサイトの設定
SubsiteThemes=サブサイトのテーマ
SureDeleteImage=この画像を削除してもよろしいですか？
SureDeleteSubsite=このサブサイトとその階層以下のサブサイトを削除してもよろしいですか？
ThemeColour=テーマカラー
ThemeColourTitle=顧客サイトのボタンに適用するブランドカラーを選択してください。
Themes=テーマ
UploadBrandLogo=ブランドロゴをアップロード
UploadBrandLogoTitle=ブランドロゴは顧客サイトの左上にアップロードされます。
UploadCoBrandingImage=共通ブランド画像をアップロード
UploadCoBrandingImageTitle=共通ブランド画像は顧客サイトの右上にアップロードされます。
VideoIntroOutro=オープニングとエンディングビデオ
FormErrorsCheckBelow=入力エラーです。内容をご確認ください。
LoginAgain=再度ログインしてください。
SubsiteSelection=サブサイトの選択
HOWTOCreateSubSite=サブサイトの登録方法
HowToSetUpSites=サイトを設定する方法
HowToSetUpYourSite=サイトの登録方法
Step1=下記に主なブランド名を入力します。
Step2=必要な場合、サブブランドを追加します。
Step3=各サブブランドに該当する地域を追加します。
Step4=ドラッグアンドドロップで各ブランドに該当する地域を追加して、階層を構築します。