AddEditRateCard=料金表の追加/編集
AddRateCard=料金表を追加
AddSupplier=サプライヤーを追加
AvailableDays=利用可能な日数
BulkDownloadRatecardsSuccessfully=料金表の一括ダウンロードを成功した
BulkUploadFailed=一括アップロード失敗。CSVファイルのフォーマットを確認してください。
BulkUploadRatecard=料金表一括アップロード
BulkUploadRatecardsSuccessfully=料金表の一括アップロードを成功した
DeliveryCost=配送費
DownloadSuppliersToCSVFile=サプライヤーをCSVファイルへのダウンロード
DownloadToCSVFile=CSVファイルへのダウンロード
EmailCCList=電子メールのCCリスト
EmailExist=電子メールアドレスは既に存在します。別のメールアドレスを入力してください
EnableFTP=FTPを有効にする
ExtraCost=追加費用
FillInSupplierName=サプライヤー名をご記入ください
FTPHost=FTPホスト
FTPPassword=FTPパスワード
FTPUsername=FTPユーザ名
LinageSettingAndDetails=リネージュの設定と詳細
LineageAvailability=リネージュの可用性
LineageSection=リネージュセクション
MediaBooking=メディア予約
MediaBookingSection=メディア予約節
MediaBookingSize=メディア予約サイズ
MediaContactSetting=媒体接触設定
MISType=MIS型
NameEmailContains=名前／メールに含まれている
RateCardId=料金表のID
RateCardName=料金表の名前
SelectMediaContactType=メディアのコンタクトタイプを選択
SelectSupplierRole=サプライヤの役割を選択してください！
SendliteEnabled=Sendlite有効
SendliteOrderUrl=Sendlite注文URLを
SendliteSettingUrl=Sendlite設定およびURL
SendliteStatusUrl=SendliteステータスURL
SendliteSubscriberNumber=Sendlite加入者番号
SetupCost=セットアップ費用
SupplierAddPage=SupplierAddPage
SupplierFTPSetting=サプライヤーFTP設定
SupplierList=サプライヤーリスト
SupplierListPage=SupplierListPage
SupplierName=サプライヤ名
UpdateRateCard=料金表を更新
UploadCSVFile=CSVファイルをアップロードしてください。
AddNewRateCard=新しい料金表を追加
Bleed=ブリード
BulkUploadRatecard1=料金表を一括アップロード
EditRateCard=料金表を編集
ExistingSupplierFound=既存のサプライヤー発見
Price=価格
RateCardBulkUpload=料金表の一括アップロード
RateCards=RateCards
SelectMediaType=メディアタイプの種類
SupplierEditPage=SupplierEditPage
SupplierEmail=サプライヤーメール
SupplierPhone=SupplierPhone
SupplierRateCard=サプライヤー料金表
SupplierRateCardPage=SupplierRateCardPage
SupplierRoles=サプライヤーの役割
SureDelete=削除してもよろしいですか？
UpdateSupplier=サプライヤを更新
CSVFile=CSVファイル
SupplierSelectSiteErrorPage=SupplierSelectSiteErrorPage
HOWTOAddSuppliers=方法：サプライヤーを追加
HowToSetUpSupplier=どのようにサプライヤーを設定するか。
MediaContact=メディア連絡先：出版物ダイレクト
PrintContact=印刷問合せ先：テンプレートに料金表を追加し、発注書を送信する権限を持った印刷サプライヤー
RegisteringAccreditedSuppliers=あなたのサイトに認定さサプライヤーを登録すると、注文要求との購入が可能になります。
Sendlite=Sendlite：第三者のメディアサプライヤー
Step1=ステップ1：サプライヤーとの接触の詳細を入力してください
Step2=ステップ2：サプライヤーの役割を設定
Step3=ステップ3：該当する場合は、FTPを設定する
DaysBefore=Day(s) Before
MaterialDate=Material Date