AddUsers=ユーザを追加
AgentId=エージェントID
BackToUserList=ユーザ一覧へ戻る
BulkUpload=バッチアップロード
CheckCSVFormat=CSVファイルしか対応しません。サンプルCSVファイルをダウンロードして正しい形式を確認してください。
CheckFormatAndUpload=サンプルCSVファイルをダウンロードして正しい形式を確認してから、CSVファイルをアップロードしてください。
ChooseCRMType=CRMの種類を選択してください。
CRMType=CRMの種類
CSVFile=CSVファイル
DeleteSelectedUsers=選択したユーザを削除
DownloadSampleCSVFile=サンプルCSVファイルをダウンロード
DownloadUsersToCSVFile=ユーザをCSVファイルにダウンロード
EditUserAddress=ユーザの住所を編集
EditUserDetails=ユーザの詳細を編集
EmailLogin=メール（ログイン）
FillInAgentId=エージェントIDを入力してください。
FillInConfirmPassword=確認パスワードを入力してください。
FillInPassword=パスワードを入力してください。
FirstnameIsMandatory=名字は必須項目です。
KeywordContains=ユーザIDとユーザ名、名前、メールに含まれます。
ListOfSubsites=サブサイト一覧
NoRightToDeleteUser=ユーザを削除する権限はありません。
PasswordConfirmPasswordSame=新しいパスワードと確認のパスワードが一致しません。
PhoneIsMandatory=電話は必須項目です。
SelectCRMType=CRMタイプを選択
SelectedSubsites=選択されたサブサイト
SelectSubsite=サブサイトを選択してください。
SettingCRM=CRMを設定
SettingUserCRM=ユーザのCRMを設定
StreetNameIsMandatory=都道府県市区町村は必須項目です。
StreetNumberIsMandatory=番地は必須項目です。
SureDeleleUsers=選択したユーザを削除してもよろしいですか？
UserAddress=ユーザの住所
UserDetails=ユーザの詳細
UserID=ユーザID
UserName=ユーザ名
UsersBulkUpload=ユーザのバッチアップロード
UserUpdated=ユーザーが更新されました。
HOWTOCreateUsers=：ユーザの作成方法
ClickOnAddUsersButton=「ユーザを追加」をクリックして、サイトへのアクセスやユーザのタイプを選択してください。
EnableCreateAndRegister=ユーザを作成・登録するができます。
HowToSetUpUsers=ユーザの設定方法
NoteOfBulkUpload=注意：CSVファイルでユーザを一括で登録する機能をご利用できます。
SureDeleteUser=ユーザを削除してもよろしいですか？
UserCreated=ユーザが作成されました
CountryIsMandatory=国は必須項目です。
IsMandatory=は必須項目です。
LastNameIsMandatory=名前は必須項目です。
MobileIsMandatory=モバイルは必須項目です。
PostcodeIsMandatory=郵便番号は必須項目です。
StateIsMandatory=州は必須項目です。
SuburbIsMandatory=郊外は必須項目です。
Profile=プロファイル
Assistant=アシスタント
MappedUser=マップされたユーザ
SelectUser=ユーザを選択
SelectedUser=選択されたユーザ：