Address=Address
Agent=Agent
Attention=Attention
Bathrooms=Bathrooms
Bedrooms=Bedrooms
BuildingSize=Building Size
Company=Company
Construction=Construction
CouncilRate=Council Rate
DueDate=Due Date
Instructions=Instructions
LandSize=Land Size
Parking=Parking
PO=PO
Point=Point
PropertyFeature=Property Feature
PropertyType=Property Type
StrataRate=Strata Rate
StreetNumber=Street Number
Study=Study
UnitNumber=Unit Number
WaterRate=Water Rate
Zoning=Zoning
Agents=Agents
AirConditioning=Air Conditioning
Alert=Alert
Backyard=Backyard
Condition=Condition
EndTime=End Time
Information=Information
Pool=Pool
Rumpus=Rumpus
StartTime=Start Time
Style=Style
ViewAspect=View / Aspect
AddEditReminder=Add/Edit Reminder
AddFile=Add file
Complete=Complete
Completed=Completed
CostInclGST=Cost
Delivery=Delivery
Note=Note
Order=Order
PendingApproval=Pending Approval
Reminder=Reminder
ResetArtwork=Reset Artwork
SaveChanges=Save Changes
Time=Time
DeliveryNote=Delivery Note
ChangeQuantity=Change Quantity
Download=Download
Checkout=Checkout
PurchaseOrderNumber=Purchase Order Number
SendApproval=Send Approval
CartName=Cart Name
OrderByInvoice=Order By Invoice
OrderByPaymentGateway=Order By Payment Gateway
OrderNow=Order Now
To=To
CartNumber=Cart Number
Item=Item
ItemId=Item Id
OrderedBy=Ordered By
ProductionDetails=Production Details
Ref=Ref
RemittanceAdvice=Remittance Advice
Surname=Surname
Ebook=Ebook
Error=Error
FinaliseArtwork=Finalise Artwork
JobCompleted=Job Completed
JobDetails=Job Details
Link=Link
Microsite=Microsite
OR=OR
OrderConfirmation=Order Confirmation
OrderStatus=Order Status
ReturnHome=Return home
ReUploadArtwork=Re-Upload Artwork
SaveHTML=Save HTML
Send=Send
SessionExpired=Your session has expired. Please click on "Return home" to Login again.
ViewHTML=View HTML
ViewOrderConfirmation=View Order Confirmation
ViewSingle=View Single
ViewSpread=View Spread
Warning=Warning
InvalidAccess=Invalid Access
LoginRequired=Login required
Success=Success
AndMobile=and mobile
AndPhone=and phone
AssetId=Asset Id
ContinueToEditor=Continue to Editor
EmailFrom=Email from
EmailSentFrom=This email was sent from
phone=phone
SessionExpired1=Session expired
WithEmailAddress=with email address
Lineage=Lineage
Publication=Publication
Comment=Comment
Media=Media
SelectRatecard=Select Ratecard
SureToProceed=Are you sure to proceed?
InvalidJob=Invalid Job
InvalidRequest=Invalid Request
AllRightsReserved=All rights reserved
BrokeSomethingOnSystem=Oops! Sorry it looks as though we've broken something on our system.
Campaigns=Campaigns
CartWaitingForApproval=Cart Waiting For Your Approval
Copyright=Copyright
DownloadImagesSuccessfully=Download {0} image(s) successfully
EndDate=End Date
Export=Export
FixingItComebackInAWhile=Don't panic, we are fixing it! Please come back in a while
FollowTheseSteps=Please follow these six easy steps
JobsWaitingForApproval=Jobs Waiting For Your Approval
LogOff=Log off
MaximumCharacterLimitIs=Maximum character limit is
Packages=Packages
PleaseSelectSubsite=Please select subsite
Register=Register
SearchHere=Search Here
SomethingWrong=Something's wrong
WelcomeToTopSnapVideoOrder=Welcome to Top Snap Video Order.
FillInSearchText=Please fill in search text.
DoYouWantToSaveTheForm=Do you want to save the property details information? Press OK to save the form data. Press Cancel to continue.
MediaScheduleReview=Media Schedule for Your Review
ViewCampaignSchedule=View Your Campaign Schedule
ViewOrderConfirmationOnline=view your order confirmation online
TemplateMapping=Template Mapping
