AddSupplier=Add Supplier
AddUsers=Add Users
AdminConsole=Admin Console
Assets=Assets
Categories=Categories
ChameleonGroup=Chameleon Group.
ChangeSubsite=Change Subsite
CompleteDetails=Complete the details on each screen and save and continue to the next screen and step.
CreateCategory=Create Category
CreateEBook=Create eBook
CreateEmailArtwork=Create Email Artwork
CreateMicroSite=Create MicroSite
CustomForm=Custom Form
Dashboard=Dashboard
Element=Element
Email=Email
Fax=Fax
FirstName=First Name
Fonts=Fonts
GotLost=Got lost?
Home=Home
Image=Image
LastName=Last Name
LogIn=Log In
LogOut=Log Out
Mobile=Mobile
News=News
Package=Package
Phone=Phone
PrintUITemplates=PRINT UI Templates
QuickHelp=Quick Help
SetupSubsites=Setup Subsites
Site=Site
SiteCreation=Site Creation
Sites=Sites
SiteSetupStage1=Site Set Up Stage 1 -
Subsite=Subsite
SubSites=Subsites
Suppliers=Suppliers
Support=Support
Template=Template
Users=Users
WelcomeMessage=Welcome to your Virtual Campaign Manager (VCM).
Add=Add
Admin=Admin
Back=Back
Change=Change
Clear=Clear
Copy=Copy
Create=Create
Delete=Delete
Edit=Edit
Error=Error:
ExpiryDate=Expiration Date
Id=Id
Images=Images
Keyword=Keyword
List=List
Management=Management
Name=Name
No=No
NOTE=NOTE:
Preview=Preview
Remove=Remove
Save=Save
Search=Search
SelectCategory=Select Category
SelectFile=Select File
SelectSite=Select Site
SelectSiteFirst=Please select a site first before proceeding.
SelectSubsite=Select Subsite
SubsiteName=Subsite Name
Templates=Templates
TextField=Text Field
Thumbnail=Thumbnail
Update=Update
Upload=Upload
View=View
Yes=Yes
ABN=ABN
Close=Close
Country=Country
DonotSelect=Don't Select
PleaseEnterName=Please enter name
Postcode=Postcode
Select=Select
SelectSupplier=Select Supplier
State=State
StreetName=Street Name
StreetNo=Street Number
Suburb=City
Supplier=Supplier
UnitNo=Unit Number
CreatedDate=Created Date
LastUpdatedDate=Last Updated Date
Title=Title
Apply=Apply
SiteName=Site Name
Size=Size
Thumbnails=Thumbnails
Approve=Approve
IllegalAccess=Illegal Access
Password=Password
Reject=Reject
Any=Any
Continue=Continue
Paypal=PayPal
Reset=Reset
GlobalDefault=Global Default
Inheritedfrom=Inherited from
User=User
Index=Index
Action=Action
SelectOneSubsite=Please select at least 1 subsite
Active=Active
False=False
Friday=Friday
Monday=Monday
Pending=Pending
Saturday=Saturday
Status=Status
Sunday=Sunday
Thursday=Thursday
True=True
Tuesday=Tuesday
Wednesday=Wednesday
AllSubsites=All Subsites
ConfirmPassword=Confirm Password
InvalidEmail=Invalid email
Roles=Roles
SaveContinue=Save & Continue
SelectTitle=Select Title
Website=Website
BackToCampaignDashboard=Back to Campaign Dashboard
BackToCart=Back to Cart
CampaignName=Campaign Name
Cart=Cart
CartId=Cart Id
GoToCart=Go to Cart
JobName=Job Name
SaveArtwork=Save Artwork
Submit=Submit
ViewArtwork=View Artwork
Artwork=Artwork
Details=Details
Owner=Owner
WorkInProgress=Work In Progress
Approved=Approved
GoToCampaignDashboard=Go to Campaign Dashboard
ItemName=Item Name
Rejected=Rejected
CampaignId=Campaign Id
Cost=Cost  $
Day=Day
EditArtwork=Edit Artwork
FinishDate=Finish Date
GST=GST
Reason=Reason
Section=Section
StartDate=Start Date
TotalCost=Total Cost
Type=Type
ClientPO=Client PO
Date=Date
DeliveryDate=Delivery Date
Failed=Failed
Invoice=Invoice
JobId=Job Id
Next=Next
OwnerName=Owner Name
Prev=Prev
ReOrder=Re-order
Start=Start
TaxInvoice=Tax Invoice
Amount=Amount
Qty=Qty
SubTotal=Sub Total
Total=Total
OrderDate=Order Date
PurchaseOrder=Purchase Order
GrandTotal=Grand Total
Price=Cost
Address=Address
Surname=Surname
