Address=住所
Agent=エージェント
Attention=注目
Bathrooms=バスルーム
Bedrooms=ベッドルーム
BuildingSize=建物の大きさ
Company=会社
Construction=工事
CouncilRate=Council Rate
DueDate=期日
Instructions=説明書
LandSize=土地サイズ
Parking=駐車場
PO=注文書
Point=ポイント
PropertyFeature=土地の特徴
PropertyType=土地の種類
StrataRate=Strata Rate (apt. upkeep fee shared by all tenants)
StreetNumber=道路番号
Study=書院
UnitNumber=ユニット番号
WaterRate=水道料
Zoning=ゾーニング
Agents=エージェント
AirConditioning=エアコン
Alert=アラート
Backyard=自宅裏
Condition=状態
EndTime=終了時間
Information=情報
Pool=プール
Rumpus=遊び部屋
StartTime=開始時間
Style=スタイル
ViewAspect=目当て / 局面
AddEditReminder=追加/編集備忘
AddFile=ファイル追加
Complete=完成
Completed=完成した
CostInclGST=代価 (税込み)
Delivery=配達
Note=メモ
Order=発注
PendingApproval=承認待ち
Reminder=備忘
ResetArtwork=アートワークをリセット
SaveChanges=変更内容を保存
Time=時間
DeliveryNote=配達目も
ChangeQuantity=量の変更
Download=ダウンロード
Checkout=チェックアウト
PurchaseOrderNumber=発注番号
SendApproval=承認を送る
CartName=カート名
OrderByInvoice=インボイスによる注文
OrderByPaymentGateway=支払いゲートウェイによる注文
OrderNow=今すぐ注文
To=宛先
CartNumber=カート番号
Item=品
ItemId=品ID
OrderedBy=注文者
ProductionDetails=製作細部
Ref=基準
RemittanceAdvice=送金通知書
Surname=名字
Ebook=電子諸説
Error=Error
FinaliseArtwork=Finalise Artwork
JobCompleted=Job Completed
JobDetails=Job Details
Link=Link
Microsite=Microsite
OR=OR
OrderConfirmation=Order Confirmation
OrderStatus=Order Status
ReturnHome=Return home
ReUploadArtwork=Re-Upload Artwork
SaveHTML=Save HTML
Send=Send
SessionExpired=Your session has expired. Please click on "Return home" to Login again.
ViewHTML=View HTML
ViewOrderConfirmation=View Order Confirmation
ViewSingle=View Single
ViewSpread=View Spread
Warning=Warning
InvalidAccess=Invalid Access
LoginRequired=Login required
Success=Success
AndMobile=and mobile
AndPhone=and phone
AssetId=Asset Id
ContinueToEditor=Continue to Editor
EmailFrom=Email from
EmailSentFrom=This email was sent from
phone=phone
SessionExpired1=Session expired
WithEmailAddress=with email address
Lineage=Lineage
Publication=Publication
Comment=Comment
Media=Media
SelectRatecard=Select Ratecard
SureToProceed=Are you sure to proceed?
InvalidJob=Invalid Job
InvalidRequest=Invalid Request
AllRightsReserved=All rights reserved
BrokeSomethingOnSystem=Oops! Sorry it looks as though we've broken something on our system.
Campaigns=Campaigns
CartWaitingForApproval=Cart Waiting For Your Approval
Copyright=Copyright
DownloadImagesSuccessfully=Download {0} image(s) successfully
EndDate=End Date
Export=Export
FixingItComebackInAWhile=Don't panic, we are fixing it! Please come back in a while
FollowTheseSteps=Please follow these six easy steps
JobsWaitingForApproval=Jobs Waiting For Your Approval
LogOff=Log off
MaximumCharacterLimitIs=Maximum character limit is
Packages=Packages
PleaseSelectSubsite=Please select subsite
Register=Register
SearchHere=Search Here
SomethingWrong=Something's wrong
WelcomeToTopSnapVideoOrder=Welcome to Top Snap Video Order.
