AnythingElse=ブラウズを続けますか？
ArnsboResponseVideoReady=Arnsboレスポンスビデオ準備完了
ArnsboResponseVideoReject=Arnsboレスポンスビデオが却下されました
Attachment=添付ファイル
CampaignHelp=キャンペーンのヘルプ
Category=カテゴリ
ChooseIntroImage=オープニングクレジットの画像を選択
ChooseOutroImage=エンディングクレジットの画像を選択
City=町
ConstructBuzControlsTest=Buz Controls Testを構築
ContactAdmin=エラー(2) サポートのメールが設定されていません。システム管理者にご連絡ください。
ContactName=連絡先
ContactNumber=連絡先番号
CreateArtwork=アートワークを作成
CustomerCode=顧客コード
DeclinedReason=却下理由
DescriptionCount=説明（200文字以上） - カウント
DownloadVideo=ビデオをダウンロード
EnsureIncludeDescription=必ず説明に含めてください。
EnsureRelevantToImages=説明は選択した画像に関連することを確認してください。
EnterCopyHere=本文を入力
EnterHeadlineHere=見出しを入力
ForgotPassword=パスワードをお忘れですか？
From=送信者
HeadlineAndCopy=見出しおよび本文
ImageName=画像名
ImageUploads=画像のアップロード
IntroImage=オープニング画像
InvalidFileExtension=無効なファイル拡張子
MinimumCharactersRequired=説明には少なくとも200文字が必要です。
MoreTraining=More Training?
NotSelected=未選択
OptionCost=オプション費用
OptionDetails=オプション詳細
OrderByPayPal=PayPalによる注文
OrderStatus=注文状況
OutroImage=エンディング画像
ProductCode=製品コード
ProductCost=製品原価
QRCode=QRコード
QRCodeHelp=QRコードのヘルプ
RatecardName=料金表の名前
ReceiveEmailNotification=ビデオが準備ができましたら、メールを通知します。
ReorderNow=今すぐ再発注
RequestSubmitted=リクエストが送信されました
ResubmitVideo=ビデオを再送信
SalesAuctionDate=販売およびオークション日
Selected=選択済み
SelectIntroImage=オープニング画像を選択してください。
SelectOutroImage=エンディング画像を選択してください。
Subject=件名
SubmitComplaint1=訴状を提出
SubmitCompllaint=完成したビデオが注文内容と異なる場合、訴状を提出してください。
SummaryDescription=サマリーの説明
SupportRequest=サポート依頼
SureToProceed=次に進めてもよろしいですか？
TargetMarketCustomer=ターゲット市場および顧客
TEST=TEST
ToneThemeProperty=物件のテーマ
TotalPriceInclGST=合計価格(税込)
UniqueSellingPoints=ユニークなセールスポイント
UploadIntroImage=オープニング画像をアップロード
UploadNewIntroImage=新しいオープニング画像をアップロード
UploadNewOutroImage=新しいエンディング画像をアップロード
UploadOutroImage=エンディング画像をアップロード
VCMSupport=VCMサポート
VideoFinish=ビデオ完了
VideoForm=ビデオのフォーム
VideoImages=ビデオ映像
VideoIsReady=ビデオが完了しました
VideoIsReady1=ビデオが完了しました
VideoOrder=ビデオの注文
VideoOrder1=ビデオの注文
VideoOrderDeclined=ビデオの注文が却下されました
VideoOrderDeclined1=ビデオの注文が却下されました。
VideoOrderSent=ビデオ注文が送信されました
VideoStatus=ビデオのステータス
VideoURL=ビデオのURL
VideoVoiceOver=ビデオの吹き替えは提供した説明を基に作成されます。
ViewVideo=ビデオを閲覧
WrongPrice=価格は正しくない
Budget=予算
CreateNew=新規作成
Impersonate=偽装
SelectASubsite=サブサイトを選択してください
SelectClientSite=クライアントサイトを選択
SendOnBoardingRequest=Send On Boarding Request
UpdateSubsiteOrdering=サブサイトの注文を更新
Activate=有効にする
AddEditRateCard=料金表を追加・編集
BackLogin=BackLogin
CancelledByRequestor=申請者によりキャンセル
FileName=ファイル名
Login=ログイン
NoItemsSelected=選択した商品がありません。
ResetPassword=パスワードをリセット
Uploaded=アップロード済み
ViewAndRespond=閲覧して応答
ViewApprovalList=承認一覧を表示
RejectedReason=却下理由
NumberOnly=数字のみ
OtherSupplier=その他のサプライヤー
YourComment=コメント
SureCancelApprovalProcess=承認を中止してもよろしいですか？
Review=レビュー
JpgGifOnly=アップロードが失敗しました。ファイルは.jpgまたは.jpeg、.gifであることを確認してください。