AddSupplier=サプライヤーを追加
AddUsers=ユーザを追加
AdminConsole=管理者画面
Assets=アセット
Categories=カテゴリ
ChameleonGroup=Chameleonグループ
ChangeSubsite=サブサイトを変更
CompleteDetails=画面の内容にある項目を記入してから次のステップへ進んでください。
CreateCategory=カテゴリを作成
CreateEBook=電子書籍を作成
CreateEmailArtwork=メールのアートワークを作成
CreateMicroSite=マイクロサイトを作成
CustomForm=カスタムフォーム
Dashboard=ダッシュボード
Element=エレメント
Email=メール
Fax=ファクス
FirstName=名前
Fonts=フォント
GotLost=ヘルプ
Home=ホーム
Image=画像
LastName=名字
LogIn=ログイン
LogOut=ログアウト
Mobile=モバイル
News=ニュース
Package=パッケージ
Phone=電話
PrintUITemplates=PrintUI テンプレート
QuickHelp=クイックヘルプ
SetupSubsites=サブサイトを登録
Site=サイト
SiteCreation=サイトを作成
Sites=サイト
SiteSetupStage1=サイト作成の第1ステップ -
Subsite=サブサイト
SubSites=サブサイト
Suppliers=サプライヤー
Support=サポート
Template=テンプレート
Users=ユーザ
WelcomeMessage=バーチャルキャンペーンマネージャー(VCM)へようこそ。
Add=追加
Admin=管理者
Back=戻る
Change=変更
Clear=クリア
Copy=コピー
Create=作成
Delete=削除
Edit=編集
Error=エラー：
ExpiryDate=有効期限
Id=ID
Images=画像
Keyword=キーワード
List=一覧
Management=管理
Name=名前
No=番号
NOTE=注意：
Preview=プレビュー
Remove=削除
Save=保存
Search=検索
SelectCategory=カテゴリを選択
SelectFile=ファイルを選択
SelectSite=サイトを選択
SelectSiteFirst=続行する前に、サイトを選択してください。
SelectSubsite=サブサイトを選択
SubsiteName=サブサイト名
Templates=テンプレート
TextField=テキストフ​​ィールド
Thumbnail=サムネイル
Update=更新
Upload=アップロード
View=表示
Yes=はい
ABN=ABN
Close=閉じる
Country=国
DonotSelect=選択しないでください
PleaseEnterName=名前を入力してください
Postcode=郵便番号
Select=選択
SelectSupplier=サプライヤーを選択
State=州
StreetName=都道府県市区町村
StreetNo=番地
Suburb=郊外
Supplier=サプライヤー
UnitNo=部屋番号
CreatedDate=作成日
LastUpdatedDate=最終更新日
Title=タイトル
Apply=適用
SiteName=サイト名
Size=サイズ
Thumbnails=サムネイル
Approve=承認
IllegalAccess=不正アクセス
Password=パスワード
Reject=却下
Any=１人の承認が必要
Continue=次へ
Paypal=ペイパル
Reset=リセット
GlobalDefault=デフォルト設定
Inheritedfrom=サイトから設定を継承
User=ユーザ
Index=インデックス
Action=アクション
SelectOneSubsite=少なくとも1つのサブサイトを選択してください
Active=有効
FALSE=偽
Friday=金曜日
Monday=月曜日
Pending=ペンディング
Saturday=土曜日
Status=ステータス
Sunday=日曜日
Thursday=木曜日
TRUE=真
Tuesday=火曜日
Wednesday=水曜日
AllSubsites=すべてのサブサイト
ConfirmPassword=パスワードを確認
InvalidEmail=無効な電子メール
Roles=役割
SaveContinue=保存して続行
SelectTitle=タイトルを選択
Website=ウェブサイト
BackToCampaignDashboard=キャンペーンのダッシュボードに戻る
BackToCart=カートに戻る
CampaignName=キャンペーン名
Cart=カート
CartId=カートID
GoToCart=カートを開く
JobName=ジョブ名
SaveArtwork=アートワークを保存
Submit=提出
ViewArtwork=アートワークを表示
Artwork=アートワーク
Details=詳細
Owner=所有者
WorkInProgress=進行中の作業
Approved=承認
GoToCampaignDashboard=キャンペーンのダッシュボードに移動
ItemName=項目名
Rejected=却下
CampaignId=キャンペーンID
Cost=価格
Day=曜日
EditArtwork=アートワークを編集
FinishDate=終了日
GST=売上税
Reason=理由
Section=セクション
StartDate=開始日
TotalCost=合計価格
Type=タイプ
ClientPO=顧客の注文書
Date=日付
DeliveryDate=配送日
Failed=失敗しました
Invoice=請求書
JobId=ジョブID
Next=次
OwnerName=所有者の名前
Prev=前のページ
ReOrder=再度注文
Start=スタート
TaxInvoice=税金請求書
Amount=金額
Qty=数量
SubTotal=小計
Total=合計
OrderDate=注文日
PurchaseOrder=注文書
GrandTotal=合計
Price=価格
Surname=姓
Address=住所