AbilityUploadPdf=Ability to upload PDF and convert into Ebook
Activate=Activate
Activated=Activated
Active=Active
AddItem=Add item
AddRateCard=Add RateCard
AddTemplate=Add Template
AndMobile=and mobile
AndPhone=and phone
Approved=Approved
BuyPrice=Buy Price
BuzCollectionCode=Buz Collection Code
BuzPriceMarkup=Buz Price Markup
BuzPricePercentage=Buz Price Percentage
BuzProductCode=Buz Product Code
ByActivatingTemplate=By activating this template it will become live for use in the system.
ByDeActivatingTemplate=By de-activating this template it will not be live for use in the system.
CannotSelectedAtSameTime=Cannot be selected at the same time for a template.
ChameleonSentInvoice=Chameleon Marketing Solutions has sent you an Invoice - Invoice
ClickCharge=Click Charge
ConvertPrintUIPDF=Converting your Print UI Indesign PDF file into an Ebook
CopyOf=Copy of
CopyTemplateAcrossSite=Copy this template across a site
CopyTemplateHere=Copy template here
CreateArtwork=Create Artwork
CreateEBook=Create E-Book Functionality
CustomizedItemType=Customized Item Type
CustomizedSize=Customized Size
DeActivate=De-Activate
DeActivated=De-Activated
DeleteSelectedTemplate=Delete Selected Template(s)
DeliveryCost=Delivery Cost
Description=Description
DescriptionCharacterLimit=Description Character Limit
Discount=Discount
DonotSelect=Do not Select
EBook=EBook
EditArtwork=Edit Artwork
EditorType=Editor Type
EditorVersion=Editor Version
EditTemplate=Edit Template
EDM=EDM
EmailFrom=Email from
EmailSentFrom=This email was sent from
EnableCreatePDF=Enables you to create a PDF in two ways.
EnableManageEmailArtwork=Enables you manage email artwork.
EnableManagePrintUITemplates=Enables you to manage PrintUI templates.
EnableQuoteRequest=Enable Quote Request
EnablesManageMicrosites=Enables you manage microsites
ExtraCost=Extra Cost
GenerateInvoice=Generate Invoice
HowToCreatEbook=1- How to Create a E-book from Print UI
HowToCreatEbook2=2- How to Create a E-book by uploading a PDF
HowToCreatEbook2Step1=Step 1:  Click on Add Template
HowToCreatEbook2Step10=Step 10: Click Back + Click On Activate to make template live
HowToCreatEbook2Step2=Step 2:  Select Editor Version V5 Editor
HowToCreatEbook2Step3=Step 3: Select Type E-Suite
HowToCreatEbook2Step4=Step 4: Select Sub-Type E-Book
HowToCreatEbook2Step5=Step 5: Enter in Template Name
HowToCreatEbook2Step6=Step 6: Select Template Behavior “Upload”
HowToCreatEbook2Step7=Step 7: Select Approval Type if applicable
HowToCreatEbook2Step8=Step 8: Map to category on right hand menu, where this item should be saved
HowToCreatEbook2Step9=Step 9: Click on Add
HowToManageEmailArtwork=HOW TO: Manage Email artwork
HowToManageMicrosites=HOW TO: Manage Microsites
HowToManagePrintUITemplates=HOW TO: Manage PrintUI templates
HowToManageTemplate=HOW TO: Manage Your Template
HowToSetUpPrintUITemplate=HOW TO: Set Up Your PrintUI Template
ItemType=Item Type
ManageEmailArtwork=Manage Email artwork
ManageEmailArtworkStep1=Step 1: Click on Assets > Template
ManageEmailArtworkStep2=Step 2: Search / and locate the Email
ManageEmailArtworkStep3=Step 3: Click on Edit button
ManageEmailArtworkStep4=Step 4: Change and Update details where applicable
ManageEmailArtworkStep5=Step 5: Change template category mapping if applicable
ManageEmailArtworkStep6=Step 6: Click on Update to save changes
ManageEmailArtworkStep7=Step 7: You may choose to Activate / Deactivate template at any time
ManageMicrosites=Manage Microsites
ManageMicrositeStep1=Step 1: Click on Assets > Template
ManageMicrositeStep2=Step 2: Search / and locate the microsite
ManageMicrositeStep3=Step 3: Click on Edit button
ManageMicrositeStep4=Step 4: Change and Update details where applicable
ManageMicrositeStep5=Step 5: Change template category mapping if applicable
ManageMicrositeStep6=Step 6: Click on Update to save changes
ManageMicrositeStep7=Step 7: You may choose to Activate / Deactivate template at any time
ManagePrintUITemplateStep1=Step 1: Select Editor Version  > Print UI
ManagePrintUITemplateStep10=Step 10: Click Add
ManagePrintUITemplateStep11=Step 11: Add Rate Card to template if applicable
ManagePrintUITemplateStep12=Step 12: Click Activate  no top right hand to make template live on the customer site
ManagePrintUITemplateStep2=Step 2: Select your Editor Type
ManagePrintUITemplateStep21=Flash: Flash based editable template allowing for more flexibility.
ManagePrintUITemplateStep22=Html:  Form Based editable template for more less flexible template.
ManagePrintUITemplateStep3=Step 3: Enter your <b>Template Name </b>
ManagePrintUITemplateStep4=Step 4: Upload Original PDF file as reference only if applicable
ManagePrintUITemplateStep5=Step 5: Enter Click Charges for template usage if applicable
ManagePrintUITemplateStep6=Step 6: Change approval process if required
ManagePrintUITemplateStep7=Step 7: Select who the Purchase Orders will be sent from when the print supplier received order
ManagePrintUITemplateStep8=Step 8: Enable Quote Request for print management if applicable
ManagePrintUITemplateStep9=Step 9: On right side menu, select the applicable categories of where you would like the template to be saved
ManageTemplateNote=Activating template makes the template live  for usage in your site. Deactivating template does not delete the template. It only hides the template from your site.
ManageTemplateStep1=Step 1: Select your Editor Type
ManageTemplateStep10=Step 10: Click Add
ManageTemplateStep2=Step 2: Select your Artwork Type
ManageTemplateStep3=Step 3: Enter your Template Name
ManageTemplateStep4=Step 4: Upload Original PDF file as reference only if applicable
ManageTemplateStep5=Step 5: Enter Click Charges for template usage if applicable
ManageTemplateStep6=Step 6: Change approval process if required
ManageTemplateStep7=Step 7: Select who the Purchase Orders will be sent from when the print supplier received order.
ManageTemplateStep8=Step 8: Enable Quote Request for print management if applicable
ManageTemplateStep9=Step 9: On right side menu, select the applicable categories of where you would like the template to be saved
MapAssetCategory=Please map this asset and select at least one Category. Your asset is not saved.
MicrositeStyle=Microsite Style
MISType=MIS Type
NeedApproval=Need Approval
None=None
OriginalPDFFile=Original PDF File
OriginalPdfFileRequired=The Original PDF File is required when you choose an old editor and template behavior is static.
Phone=Phone
POSentFrom=PO Sent From
Price=Price
PriceSchema=Price Schema
Print=Print
Publication=Publication
Quantity=Quantity
RateCardName=RateCard Name
Select=Select
SelectClientSite=Select Client Site
SelectEditorType=Select Editor Type
SelectEditorVersion=Select Editor Version
SelectItemType=Select Item Type
SelectMicrositeStyle=Select Microsite Style
SelectNeedApproval=Select Need Approval
SelectPOSentFrom=Select PO Sent From
SelectSize=Select Size
SelectSubType=Select Sub Type
SelectTemplateItemSize=Select Template Item Size
SelectTemplateItemType=Select Template Item Type
SelectTemplateSubtype=Please select Template Sub Type.
SelectTemplateType=Please select Template Type.
SelectType=Select Type
SendInvoice=Send an invoice to charge for the template if applicable
SettingUpTemplateRules=Setting up template rules.
SetupCost=Setup Cost
ShowPropertySmartForm=Show Property Smart Form
Size=Size
Specifications=Specifications
SpecificationsName=Specifications Name
SpecificationsValue=Specifications Value
Status=Status
Step1=Step 1: Search and Select your PrintUI Template
Step2=Step 2: Click on edit
Step3=Step 3: Under the heading Template Behaviors select “Ebook enabled”
SubType=SubType
SureDeleteCheckedTemplates=Are you sure you want to delete these checked Template(s)?
SureRemoveItem=Are you sure to remove this item?
TemplateAddPage=Template Add Page
TemplateBehaviours=Template Behaviors
TemplateEditPage=Template Edit Page
TemplateList=Template List
TemplateListPage=Template List Page
TemplateMappingRequired=Template creation/mapping required
TemplateName=Template Name
TotalNumber=Total Number:
Type=Type
Undefined=Undefined
UpdateRateCard=Update RateCard
UpdatingTemplate=Updating Template
ViewAndRespond=View and Respond
WaitingClientApproval=Waiting for client approval of Template
WaitingTemplateCreated=Waiting for template to be created
Website=Website
WithEmailAddress=with email address
AddEditRateCard=Add/Edit RateCard
LastUpdatedBy=Last Updated By
LastUpdatedDate=Date Last Updated
MappedRatecards=Mapped Ratecards
PriceSpecification=Price Specification
TemplatePreview=Template Preview
AddNewRateCard=Add New RateCard
CCEmailList=CC Email List
CCEmailListDesc=CC Email List (please use , or ; without spaces to separata between emails)
CompanyName=Company Name
EditRateCard=Edit RateCard
ExistingCompanyFound=Existing Company Found
PreviousInvoice=Previous Invoice
PreviousInvoiceSentDate=Previous Invoice Sent Date
RateCard=Rate Card
SelectMISType=Select MIS Type
TemplateCreationPrice=Template Creation Price
TemplateCreationPriceExclGst=Template Creation Price
TemplateId=Template Id
TemplateInvoice=Template Invoice
TemplateInvoicePage=Template Invoice Page
TemplateRateCardPage=Template RateCard Page
TemplateSelectSiteErrorPage=Template Select Site Error Page
FillInCompanyName=Please fill in the company name.
TemplateDetails=Template Details
AddColourPalette=Add Color Palette
AddEditColourPalette=Add/Edit Color Palette
Colour=Color
ColourPalette=Color Palette
EditColourPalette=Edit Color Palette
FifthAttribute=Fifth Attribute
FirstAttribute=First Attribute
FouthAttribute=Fouth Attribute
MappedColourPalette=Mapped Color Palette
SecondAttribute=Second Attribute
SelectColourPalette=Select Color Palette
TemplateColourPalette=Template Color Palette
ThirdAttribute=Third Attribute
HeadlineCharacterLimit=Headline Character Limit
TemplatePreset=Template Preset
SelectPreset=Select Preset
PrintUITemplateSetting=PrintUI Template Setting
TaxRate=Tax Rate
