AddEditRateCard=Add/Edit RateCard
AddRateCard=Add RateCard
AddSupplier=Add Supplier
AvailableDays=Available Days
BulkDownloadRatecardsSuccessfully=Bulk download RateCards was successful.
BulkUploadFailed=Bulk upload failed; please check the format of csv file.
BulkUploadRatecard=Bulk Upload Ratecard
BulkUploadRatecardsSuccessfully=Bulk upload ratecards successfully.
DeliveryCost=Delivery Cost
DownloadSuppliersToCSVFile=Download suppliers to CSV file
DownloadToCSVFile=Download to CSV File
EmailCCList=Email CC List
EmailExist=Email address already exists in the system. Please enter another email address.
EnableFTP=Enable FTP
ExtraCost=Extra Cost
FillInSupplierName=Please fill in supplier name
FTPHost=FTP Host
FTPPassword=FTP Password
FTPUsername=FTP Username
LinageSettingAndDetails=Linage Setting and Details
LineageAvailability=Lineage Availability
LineageSection=Lineage Section
MediaBooking=Media Booking
MediaBookingSection=Media Booking Section
MediaBookingSize=Media Booking Size
MediaContactSetting=Media Contact setting
MISType=MIS Type
NameEmailContains=Name / Email Contains
RateCardId=RateCard Id
RateCardName=RateCard Name
SelectMediaContactType=Select Media Contact Type
SelectSupplierRole=Please select supplier role!
SendliteEnabled=Sendlite Enabled
SendliteOrderUrl=Sendlite Order Url
SendliteSettingUrl=Sendlite setting and Url
SendliteStatusUrl=Sendlite Status Url
SendliteSubscriberNumber=Sendlite Subscriber Number
SetupCost=Setup Cost
SupplierAddPage=Supplier Add Page
SupplierFTPSetting=Supplier FTP setting
SupplierList=Supplier List
SupplierListPage=Supplier List Page
SupplierName=Supplier Name
UpdateRateCard=Update RateCard
UploadCSVFile=Please upload CSV File.
AddNewRateCard=Add New RateCard
Bleed=Bleed
BulkUploadRatecard1=Bulk Upload RateCard
EditRateCard=Edit RateCard
ExistingSupplierFound=Existing Supplier Found
Price=Price
RateCardBulkUpload=RateCard Bulk Upload
RateCards=RateCards
SelectMediaType=Select Media Type
SupplierEditPage=Supplier Edit Page
SupplierEmail=Supplier Email
SupplierPhone=Supplier Phone
SupplierRateCard=Supplier RateCard
SupplierRateCardPage=Supplier RateCard Page
SupplierRoles=Supplier Roles
SureDelete=Are you sure you want to delete?
UpdateSupplier=Update Supplier
CSVFile=CSV File
SupplierSelectSiteErrorPage=Supplier Select Site Error Page
HOWTOAddSuppliers=HOW TO: Add Suppliers
HowToSetUpSupplier=HOW TO: Set Up Suppliers.
MediaContact=Media Contact: Publications direct
PrintContact=Print Contact: Print Suppliers with ability to add rate cards to templates and send purchase orders
RegisteringAccreditedSuppliers=Registering accredited suppliers into your site will enable order requests and purchases.
Sendlite=Media Broker: Third party media supplier
Step1=Step 1:  Enter in Supplier contact details
Step2=Step 2: Set up supplier roles
Step3=Step 3:  Set up FTP if applicable
DaysBefore=Day(s) Before
MaterialDate=Material Date
