AddTask=タスクを追加する
Campaign=キャンペーン
CampaignDashboard=CampaignDashboard
CampaignDashboard1=キャンペーンのダッシュボード
CampaignModified=キャンペーンが変更されました。あなたが保存しますか？」
CanNotCopyIndesignPluginJob=Indesignのプラグインの仕事をコピーすることはできません
CompleteCampaign=コンプリートキャンペーン
CompleteUnfinishedPackageItems=あなたは、キャンペーンでパッケージを選択しました。完全なキャンペーンの前に未完成のパッケージ項目を入力してください。
FillInInformation=あなたがあなたの財産の詳細タブ内のすべての情報を入力しており、事前のアートワークを作成するプロパティ画像]タブで画像をアップロードしていることを確認してください。
MediaDetails=メディア詳細
NoJobsCompleted=どんな仕事が完了していない。
PrintingCost=印刷費
PrintOptions=印刷オプション
PropertyDetails=不動産の詳細
PropertyImages=プロパティの画像
SaveChanges=変更の保存
SelfCreate=自己の作成
TotalExclGST=合計（除GST）：
Attention=注目
CampaignImagesProcessing=CampaignImagesProcessing
CampaignImagesQueue=キャンペーンのイメージキュー
CompletedWork=CompletedWork
CompletedWork1=完成工事
CurrentWork=CurrentWork
CurrentWork1=現在の仕事
Delivery=配達
DeliveryDetails=配達またはインストールの詳細
DeliveryNote=納品書
FailedMessage=失敗したメッセージ
Note=注意
OrderConfirmation=注文確認
Processed=処理された
Processing=処理
PropertyImageId=性状画像のId
RefreshPage=ページを更新する
SearchOptions=検索オプション
SignboardInstallationDate=看板の設置日
SignboardInstallationNote=看板インストレーションノート
SureCopyCampaign=あなたは、キャンペーンをコピーしてもよろしいですか
SureDeleteCampaign=あなたがキャンペーンを削除してもよろしいです
UnProcessed=未処理の
BANKINGDETAILS=バンキング詳細
ChequeCanBeMadeTo=小切手をにすることができる
EFTPayments=EFTの支払いはに対して行うことができる
Ref=参照
RemittanceAdvice=送金通知書
TearOffReturnPayment=はがす＆支払いに返却してください
OrderContactDetails=ご注文連絡先の詳細
PAID=PAID
ClickToViewPositionalDiagram=位置図を表示するにはここをクリック
CommentsInstructions=コメント/取扱説明書
InspectionDate=検査日
InstallationDetails=インストールの詳細
JobDetails=ジョブの詳細
PaymentDetails=支払詳細
PositionalDiagram=定位置ダイアグラム
ProductionDetails=生産詳細
PropertyAddress=物件アドレス
QualityAndSatisfaction=品質と印刷の満足度は、プリンタとあなたの顧客あなたとの間にある。カメレオンは、アートワークに表示されるすべてのエラーの責任を負いかねます。それはあなたの顧客満足度を確実にするために前に完全な印刷生産へのアートワークの印刷またはオンライン証明を提供することが不可欠です。
ReloadFromCRM=CRMから再読み込み
AddAgent=エージェントを追加
AddInspection=検査を追加
AdditionalFields=追加フィールド
AddPoint=ポイントの追加
AuctionDate=入札日
AuctionLocation=オークションの場所
AuctionTime=オークションの時間
BulletPoints=箇条書き
DisplayImages=表示画像（S）
ExceedMaximumUploadLimit=あなたは、バッチアップロードあたり50メガバイトの最大アップロード制限を超えました。削減し、もう一度試してください。
ImageName=画像名
ImagesBeingProcessed=あなたの画像（S）処理されている、お待ちください。リロードキャンペーンは、画像（複数可）をリロードするか、キューを表示するには、表示画像（複数可）をクリックするにはクリックしてください。
ListingDetails=物件詳細
ListingType=リストの種類
PriceGuide=価格ガイド
PropertyDescription=プロパティ説明
PropertySummary=プロパティの概要
ReloadCampaign=リロードキャンペーン
SavePropertyDetailsAndMarketing=保存不動産の詳細とマーケティング
SignboardDescription=看板説明
SignboardSummary=看板の概要
UploadImages=画像をアップロード
UploadLimit=あなたは、一度に50メガバイトの合計で最大アップロードすることができますのでご注意ください。
AddMoreItemsToCampaign=キャンペーンに複数のアイテムを追加します。
AddNewNote=新しいメモを追加します。
AddNotes=メモを追加
CreateYourArtwork=あなたのアートワークを作成
DeliveryInstallation=配信/インストール
EditExistingTask=既存のタスクを編集
GrandTotalExclGST=総計（除GST）：
NoteName=音名
PrintOptionsAndDelivery=印刷オプションと配信
ProcessingRequest=リクエストを処理して、しばらくお待ちください...
ReadyToDownload=ダウンロードする準備ができて
ReadyToSendToPublication=出版に送信する準備
SendForApproval=へ承認のためにそれを送る
SendToVendorForApproval=承認のためにベンダーに送る
SentToPrintOn=に印刷するために送信される
SentToPublicationOn=上の出版物に送られた
TaskName=タスク名
TotalInclGST=合計（税込GST）
ViewCancelApproval=表示/キャンセル承認