BANKINGDETAILS=バンキング詳細
CartDashboard=CartDashboard
ChangeQuantity=変化量
ChequeCanBeMadeTo=小切手をにすることができる
CommentsInstructions=コメント/取扱説明書
ConfirmCart=カートの確認
DeliveryAttention=配達注意
EditExistingItem=既存の項目を編集します
EditInfo=編集情報
EFTPaymentsCanBeMadeTo=EFTの支払いはに対して行うことができる
MetroDeliveryIncludedInCost=メトロ配信は原価に含ま
Options=オプション
OrderByPaymentGateway=支払いゲートウェイでの注文
OrderContactDetails=ご注文連絡先の詳細
OrderDeliveryDetails=注文配達詳細
PaidAndSentToPrintOn=有料とに印刷するために送信される
PriceExclGST=価格（除くGST）
PriceIinclGST=価格（税込GST）
PrintingCost=印刷費
TearOffReturnWithPayment=はがす＆支払いに返却してください
TotalCostInclGST=トータルコスト税込GST
YourCartWaitingForApproval=カートは承認を待っている
DeliveryInstructions=配達指示
PaymentDetails=支払詳細
CompletedAt=で完了
HasRequestedApproval=彼らのアートワークのための承認を要求した（S）
InProgress=進行中
OrderBy=通り過ぎて秩序
PBSCartDashboard=PBSCartDashboard
SureToDeleteItem=あなたはこの項目を削除してもよろしいですか？