AddGuest=ユーザーレビューを追加
AddGuestNames=追加し、あなたのゲストの名前を入力してください。
Age=年齢
AreYouSure=本気ですか？
Birthday=誕生日
Branch=ブランチ
BranchCode=支店コード
BriefIsBeingReviewed=あなたのブリーフでは検討されている。
Circle=サークル
ClearGlossVinyl=クリアグロスビニール
ClearSynthetic=クリア合成
ClearSyntheticElectrostatic=クリア合成静電
Client=クライアント
Contact=コンタクト
CustomQuoteRequest=カスタム見積もり依頼
CustomSize=カスタムサイズ
DeclinedReason=辞退理由
DescriptionAtLeast200Characters=説明には、少なくとも200文字でなければなりません。
DieShape=シェイプダイ
DownloadQRCode=QRコードをダウンロード
DownloadVideo=ダウンロードビデオ
EnsureRelevantToImages=この説明は、選択した画像に関連することを確認してください
EnterBranchCode=あなたの支店コードを入力してください
EnterBranchCodeToRegister=登録してあなたの支店コードを入力してください。
EnterDetailsForRegistration=登録のためにあなたの詳細を入力してください
FillInConfirmPassword=確認パスワードをご記入ください。
FillInDescription=説明をご記入ください。
FillInFirstName=最初の名前を記入してください。
FillInLastName=姓を記入してください。
FillInNameAgePhoto=名前、年齢、アップロード写真をご記入ください。
FillInPassword=パスワードを入力してください。
FillInPropertyAddress=物件アドレスをご記入ください。
FillInPropertyCityOrSuburb=プロパティ都市または郊外にご記入下さい。
FillInPropertyPostcode=プロパティの郵便番号をご記入ください。
FillInValidEmail=有効なメールアドレスを記入してください。
GlossPaper=グロス紙
Guest=ゲスト
InfoSetting=InfoSetting
IntroImage=イントロ画像
IntroVoiceOver=イントロボイスオーバー
InvalidEmailAndPassword=ログインの無効な電子メールとパスワードを入力します。
IsPrinted=印刷されていますか？
LabelQuoteRequest=ラベル見積りサービス
LastNameIsMandatory=姓は必須フィールドです。
MandatoryFields=必須フィールド
NarrowEdge=狭いエッジ
NotAvailable={0}は使用できません
NotReady='{0}'の準備ができていません。管理者に連絡してください。
OutroImage=エンディング画像
OutroVoiceOver=エンディングボイスオーバー
Oval=オーバル
PaperWithBlockOutDarkLayer=ブロックアウトと紙（ダーク層）
PaperWithBlockOutSilverLayer=ブロックアウトと紙（銀層）
PiggybackPaperOnPaper=紙に便乗紙
PrintedOneSide=印刷された片側
PrintedTwoSides=印刷された二辺
QRCode=QRコード
QuoteQTY=見積もりQTY
Rectangle=長方形
Reference=リファレンス
RegisteredSuccessfully=あなたが正常に登録されています。
Registration=登録
RemovableClearSynthetic=取り外し可能なクリア合成
RemovableGlossPaper=リムーバブル光沢紙
RepositionableGlossPaper=再配置可能な光沢紙
ResubmitVideo=再送信ビデオ
SettingInfo=情報を設定する
SomethingWrongWithVideoOrder=ビデオ注文と間違って何かがある
Step1=私たちのシステムへのステップ1レジスタ
Step5YourBriefReviewed=ステップ5あなたの簡潔なが検討されている
Step5YourVideoProduced=ステップ5あなたのビデオが生成されている
Step6VideoIsReady=ステップ6あなたのビデオの準備ができている
Stock=株式
SubmitAComplaint=あなたは間違いがあなたのビデオに行われていると思われる場合は、苦情を提出してください。
SubmitComplaint=訴状を提出
SubsiteNotConfigured=動画の注文のためのサブサイトが設定されていない、トップスナップまでご連絡ください。
TargetMarketCustomer=ターゲット市場/顧客
UncoatedPaper=コーティングしていない紙
Unique=ユニーク
UniqueSellingPointsWowFactor=ユニークなセールスポイント/うわー要因
UnPrinted=国連プリント
Upload8Images=少なくとも8画像をアップロードしてください
UploadAndSave=アップロードして保存
UploadCompanyLogoForIntro=あなたのイントロのために会社のロゴをアップロードしてください
UploadCompanyLogoForOutro=あなたのアウトロのために会社のロゴをアップロードしてください
UploadedImages=アップロードされた画像
UploadFile=ファイルのアップロード
UserDetails=ユーザーの詳細
VideoFinish=VideoFinish
VideoIsBeingProduced=あなたのビデオが生成されている。それは準備ができているように我々はすぐにそれをメールでお知らせいたします。
VideoIsReady=あなたのビデオは、準備ができています。
VideoIsReady1=あなたのビデオが準備ができています。ここにあなたのビデオです。
VideoOrderDeclined=あなたのビデオ注文は減少してきた。
VideoRequestDeclined=あなたのビデオ要求が減少してきた。
VideoTemplateNotFound=ビデオのテンプレートが見つからない、トップスナップまでご連絡ください。
VideoURL=動画のURL
VideoWaitingToBeReviewed=検討すべき映像の待機があります。
WeWillContactYou=私たちはあなたの簡潔なの見直しをしている。何か問題がある場合、我々はそうでないあなたのビデオが48時間で生産され、ご連絡させていただきます。
WeWillEmaiIt=あなたのビデオは、48時間で生産されている。それは準備ができているように我々はすぐにそれをメールでお知らせいたします。
WideEdge=ワイド端
DescriptionCount=説明（最小200文字必須） - カウント
EnsureIncludeInDescription=あなたがあなたの記述に含まれることを確認してください
ToneThemeOfTheProperty=プロパティのトーン/テーマ
VideoVoiceOver=ビデオの声が上に提供される説明をオフに基づいて行われます
Minimum200=最小200文字は説明のために必要。
PropertyDetails=不動産の詳細
SalesAuctionDate=販売/オークション日
Step3LogIntoSystem=私たちのシステムにステップ3ログインします
UploadCompanyLogo=あなたの会社のロゴ、およびプロパティの画像をアップロードします。その後、提供形で、プロパティの詳細を供給
VideoForm=VideoForm