AvailableDates=利用可能日時
Border=罫線
CheckItemsToSubmit=送信する内容をご確認ください。
EnterEmailSubject=メールの件名を入力してください。
EnterEmailSubject1=メールの件名を入力
ForReviewAndApproval=あなたのレビューと承認のための系統広告を提出した。
FullColour=フルカラー
GoToHistory=歴史に行く
GoToList=一覧へ
HasAcceptedLineage=受け入れ系統を持って
HasRejectedLineage=拒否された系統を持って
Headline=見出し
InsertionDate=挿入日
InvalidCopy=無効なコピー
InvalidDate=無効な日付
InvalidHeadline=無効なヘッドライン
InvalidSuburbSelected=無効な郊外に選択
LinageEdit=LINAGE - 編集
LineageCreate=リネージュ - 作成
LineageHasBeenAccepted=リネージュは受け入れられてきた
LineageHasBeenRejected=あなたの系譜は拒否されました
LineageHasBeenSubmitted=リネージュの広告が送信されました
LineageList=リネージュ一覧
LineageListAdmin=リネージュ一覧 - 管理
LineageListAdminHistory=リネージュリスト - 管理者（歴史）
LineageListSupplier=リネージュリスト - サプライヤー
ListAdmin=ListAdmin
ListSupplier=ListSupplier
Logo1=ロゴ×1
Logo2=ロゴ×2
LogoLC9790=ロゴLC9790
LogoTC9790=ロゴTC9790
NoItemsAvailable=利用可能なアイテムはありません
NoItemsSelected=選択したアイテムはありません
NoPublicationsAvailable=利用できません出版物
OnlyNumaricsAllowed=唯一Numaricsが許可
PropertyAddress=物件アドレス
PropertyDescription=プロパティ説明
PropertySearch=物件検索
PropertySuburb=プロパティ郊外
RejectedLineage=あなたの系譜を拒否しました
SureToApproveSelectedItems=あなたが選択したすべての項目を承認してもよろしいですか？
SureToDeleteLineage=あなたはこの系統を削除してもよろしいですか？
SureToDeleteSelectedItems=あなたが選択したすべての項目を削除してもよろしいですか？
SureToRejectAllSelectedItems=あなたが選択したすべての項目を拒否するか？
SureToSubmitSelectedItems=あなたが選択したすべての項目を提出してもよろしいですか？
TwoDecimalPlacesAllowed=二つの小数点以下の桁のみが許可された
ViewLineageList=これらの系統の一覧を表示してください
ViewLineageList1=あなたの系譜の一覧を表示する
YouHaveItemsInList=あなたは、リスト内の{0}アイテムを持っている