AgentName=エージェント名
AppearanceDate=発行日
AppearanceDateBiggerThan=- {0}より後の発行日が表示されます。
BookingNumber=予約番号
BookMedia=広告スペースを予約
ChooseBookingFirst=先に予約を行なってください。
ClickHere=ここをクリック
EnterBookingNumberHere=ここに予約番号を入力してください。
GoToApprovedList=承認一覧へ
HasAcceptedMediaBookingRequest=から広告スペースの予約申請が承認されました
HasRejectedMediaBookingRequest=から広告スペースの予約申請が却下されました
InvalidAppearanceDate=無効な発行日
MaterialDate=実日
MediaBooking=広告スペース予約
MediaBookingList=広告スペース予約申請一覧
MediaBookingListApproved=広告スペース予約申請(承認済み)
MediaBookingRequest=広告スペース予約申請 - 依頼
MediaBookingRequestAccepted=広告スペースの予約申請が承認されました。
MediaBookingRequestFrom=広告スペースの予約申請が承認されました：
MediaBookingRequestRejected=広告スペースの予約申請が却下されました。
NoMediaAvailable=利用できるスペースがありません。
PressAdBookingRequest=広告スペース予約申請
RemoveMediaBooking=広告スペースの予約申請を削除
RequestHasBeenSent=広告スペースの予約を受け取りました。ご確認の程よろしくお願い致します。<br /><br />不明点がございましたら、下記までご連絡ください。<br /><br />
ReSendBookingRequest=予約申請を再送
SendBookingRequest=予約申請を送信
SummaryDescription=サマリー
SureDeleteRequest=予約の申請を削除してもよろしいですか？
SureUpdateBookingNumber=予約番号を更新してもよろしいですか？
ViewMediaBookingRequestList=広告スペースの予約申請一覧を表示
ViewRequestList=申請リストを表示