ArtworkIsCompleted=アートワークが完成しました
ArtworkReadyToOrder=アートワーク注文の準備ができました。
ArtworkReadyToSend=アートワーク送信の準備ができました。
AvailableBookings=利用可能な広告スペース
AvailableSuppliers=利用可能なサプライヤー
BackToQuoteRequest=見積り依頼へ戻る
BookingNumber=予約番号
CompletedJobsInPackage=パッケージ内の{1}点のジョブのうち、{0}点が完了しました。
EnterMediaBookingNumber=広告スペースの予約番号を入力してください
EnterQuoteIncGST=見積りを税込価格で入力してください。
FillInDeliveryDetails=配送の詳細を入力してください。
FillInPublicationEmail=メール入力してください。
GoToRequestResult=依頼画面に移動
HasRequestedQuote=から見積り依頼が届きました
HasResponsedQuoteRequest=から見積り依頼の返答が届きました
HasSentArtwork=からアートワークが送信されました
HasSentInvoice=から請求書が送信されました
HasSentPurchaseOrder=から注文書が送信されました
HasSentQuoteRequest={0}から{1}の見積り依頼が届きました
MediaBookingNumber=広告スペースの予約番号
NoAvailableSuppliersSelected=利用可能なサプライヤーが選択されていません
NumberOnly=数字のみ
OrderReady=注文待ち
PackageIsNullPleaseCheck=パッケージが空です。テンプレートまたはパッケージの設定を確認してください。
PleaseWaitHiResArtwork=高解像度アートワークはサプライヤーに送信します。もうしばらくお待ちください...
PleaseWaitOrderBeingProcessed=ご注文が処理されている間お待ちください...
PositionalDiagram=Positional Diagram
QuoteQuantity=見積りの量
QuoteRequestResult=見積り結果
ReadyToOrder=注文可能
ReadyToSend=送信可能
RequestedDate=希望日
RequestedQuantity=希望量
RequestHasBeenAcceptedBy={0}が見積りを受け取りました。
RequestHasBeenCancelledBy={0}が申請を取り消しました。
RequestQuotes=見積りを依頼
RequestsSent=送信済みリクエスト
ResponsedDate=返答日
SelectQuantityGetFinalPrice=最終価格を計算ために数量を選択してください
SelectSuppliersToSendQuoteRequest=見積依頼の宛先サプライヤーを選択してください。
SendToPublication=印刷会社に送信
SendToSendlite=Sendliteに送信
SubmitQuote=見積りを提出
SuccessfullyResponsedWithPrice=見積りが正常に送信されました。
SupplierQuoteRequest=サプライヤーへの見積り依頼
SureOrderWithThisSupplier=選択したサプライヤーに注文してもよろしいですか？
SureSendRequestToSelectedSupplier=あなたが選択した取引先に要求を送信してもよろしいですか？
UploadingError=アップロードが失敗しました。もう一度お試しください。
ViewAndDownloadArtwork=アートワークを確認してダウンロード
ViewAndRespond=表示して返答
ViewOrderConfirmationOnline=注文確認をオンラインで表示
ViewTheRequest=依頼を表示
YouHaveResponsedWithPrice=見積りを送信しました。
SendQuoteRequest=見積り依頼を送信
EnterEmailForOtherSupplier=別のサプライヤーを選択する場合、メールアドレスを入力してください。