AgentName=Agent Name
AppearanceDate=Appearance Date
AppearanceDateBiggerThan=- This only displays items that the appearance date is bigger than {0}
BookingNumber=Booking Number
BookMedia=Book Media
ChooseBookingFirst=Please choose a booking first.
ClickHere=click here
EnterBookingNumberHere=Enter Booking Number here
GoToApprovedList=Go to Approved List
HasAcceptedMediaBookingRequest=has accepted Media Booking Request
HasRejectedMediaBookingRequest=has rejected Media Booking Request
InvalidAppearanceDate=Invalid Appearance Date
MaterialDate=Material Date
MediaBooking=Media Booking
MediaBookingList=Media Booking List
MediaBookingListApproved=Media Booking List (Approved)
MediaBookingRequest=Media Booking - Request
MediaBookingRequestAccepted=Media Booking Request has been accepted
MediaBookingRequestFrom=Media Booking Request from
MediaBookingRequestRejected=Media Booking Request has been rejected
NoMediaAvailable=No Media available
PressAdBookingRequest=Press Ad Booking Request
RemoveMediaBooking=Remove Media Booking
RequestHasBeenSent=A request for a press ad booking has been sent to you for review and action. <br /><br /> Should you require any assitance or have any questions on setting up your site, <br />Please contact :<br /><br />
ReSendBookingRequest=Re-Send Booking Request
SendBookingRequest=Send Booking Request
SummaryDescription=SummaryDescription
SureDeleteRequest=Are you sure to delete this media booking request?
SureUpdateBookingNumber=Are you sure to update booking number?
ViewMediaBookingRequestList=view your Media Booking Request list
ViewRequestList=View the request list
