BANKINGDETAILS=BANKING DETAILS
CartDashboard=CartDashboard
ChangeQuantity=Change Quantity
ChequeCanBeMadeTo=Check can be made to
CommentsInstructions=Comments / Instructions
ConfirmCart=Confirm Cart
DeliveryAttention=Delivery Attention
EditExistingItem=Edit Existing Item
EditInfo=Edit Info
EFTPaymentsCanBeMadeTo=EFT Payments can be made to
MetroDeliveryIncludedInCost=Metro delivery included in cost
Options=Options
OrderByPaymentGateway=Order By Payment Gateway
OrderContactDetails=Order Contact Details
OrderDeliveryDetails=Order Delivery Details
PaidAndSentToPrintOn=Paid and Sent to Print on
PriceExclGST=Cost
PriceIinclGST=Cost
PrintingCost=Printing Cost
TearOffReturnWithPayment=Please tear off & return with payment
TotalCostInclGST=Total Cost Incl GST
YourCartWaitingForApproval=Your Cart is waiting for approval
DeliveryInstructions=Delivery Instructions
PaymentDetails=Payment Details
CompletedAt=Completed at
HasRequestedApproval=has requested approval for their artwork(s)
InProgress=In progress
OrderBy=Order By
PBSCartDashboard=PBSCartDashboard
SureToDeleteItem=Are you sure to delete this item?
