AcceptSoleResponsibility=I accept sole responsibility for managing both production and delivery of this artwork, either via in-house production or via an external supplier.
ArtworkHasBeenSentToPublication=Artwork has been sent to publication.
Brochure=Brochure
CollectionOrderStatus=Collection Order Status
CustomizedEmailSubject=Customized Email Subject
DownloadQRCode=Download QR Code
Emailer=Emailer
ErrorRequestingStatus=Error requesting status
ErrorSendingToPublication=Error sending to publication
FillInLinkShortcutName=Please fill in link shortcut name.
FillInPublicationEmail=Please fill in publication email.
HasSentArtwork=has sent you an artwork.
LinkShortcutName=Link Shortcut Name
LinkShortcutNameHasBeenUsed=Link shortcut name has been used; please select another shortcut name.
MediaEmailAddress=Media email address
OrderCollection=Order Collection
OrderDateTime=Order Date/Time
PressAds=PressAds
PublicationEmailAddress=Publication Email Address
PurchaseOrderHasBeenSent=Purchase Order has been sent
PurchaseOrderSentTo=Your purchase order was sent to
QRCode=QR Code
ReadyToDownloadAndSaveArtwork=You are ready to download and save your artwork.
ReSendToPublication=Re-Send to Publication
SaveHTMLAsZIP=Save HTML As .ZIP
SendHTMLFileToEmail=Send HTML File to Email
SentDate=Sent Date
Signboard=Signboard
BackToDashboard=Back to Dashboard
DispatchOptions=Dispatch Options
PreviewOptions=Preview Options
SaveAsZipToDesktop=Save as .ZIP file to desktop
SaveOptions=Save Options
ViewEmailInBrowser=View Email in browser
ViewMicrositeInBrowser=View Microsite in browser
EmailOptions=Email Options
MicrositeOptions=Microsite Options
