AvailableDates=Available Dates
Border=Border
CheckItemsToSubmit=Please check item(s) to submit.
EnterEmailSubject=Please enter Email Subject.
EnterEmailSubject1=Enter email subject.
ForReviewAndApproval=has submitted lineage ad for your review and approval.
FullColour=Full Color
GoToHistory=Go to History
GoToList=Go to List
HasAcceptedLineage=has accepted lineage.
HasRejectedLineage=has rejected lineage.
Headline=Headline
InsertionDate=Insertion Date
InvalidCopy=Invalid Copy
InvalidDate=Invalid Date
InvalidHeadline=Invalid Headline
InvalidSuburbSelected=Invalid Suburb selected
LinageEdit=Linage - Edit
LineageCreate=Lineage - Create
LineageHasBeenAccepted=Lineage has been accepted.
LineageHasBeenRejected=Your lineage has been rejected.
LineageHasBeenSubmitted=Lineage Ad has been submitted by
LineageList=Lineage List
LineageListAdmin=Lineage List - Admin
LineageListAdminHistory=Lineage List - Admin (History)
LineageListSupplier=Lineage List - Supplier
ListAdmin=ListAdmin
ListSupplier=ListSupplier
Logo1=Logo x 1
Logo2=Logo x 2
LogoLC9790=Logo LC9790
LogoTC9790=Logo TC9790
NoItemsAvailable=No items available
NoItemsSelected=No items selected
NoPublicationsAvailable=No publications available
OnlyNumaricsAllowed=Only Numerics allowed
PropertyAddress=Property Address
PropertyDescription=Property Description
PropertySearch=Property Search
PropertySuburb=Property Suburb
RejectedLineage=rejected your lineage
SureToApproveSelectedItems=Are you sure you want to APPROVE all selected items?
SureToDeleteLineage=Are you sure you want to delete this lineage?
SureToDeleteSelectedItems=Are you sure you want to DELETE all selected items?
SureToRejectAllSelectedItems=Are you sure you want to REJECT all selected items?
SureToSubmitSelectedItems=Are you sure you want to SUBMIT all selected items?
TwoDecimalPlacesAllowed=Only two decimal places are allowed.
ViewLineageList=Please view these lineage list.
ViewLineageList1=view your lineage list.
YouHaveItemsInList=You have {0} items in the list.
