ArtworkIsCompleted=Your Artwork is completed.
ArtworkReadyToOrder=Your Artwork is ready to order.
ArtworkReadyToSend=Your Artwork is ready to send.
AvailableBookings=Available Bookings
AvailableSuppliers=Available Suppliers
BackToQuoteRequest=Back to Quote Request
BookingNumber=Booking Number
CompletedJobsInPackage=You have completed {0} / {1} jobs in your package.
EnterMediaBookingNumber=Enter Media Booking Number
EnterQuoteIncGST=Enter Quote
FillInDeliveryDetails=Please fill in delivery details.
FillInPublicationEmail=Please fill in publication email.
GoToRequestResult=Go to Request Result
HasRequestedQuote=has requested a quote.
HasResponsedQuoteRequest=has responsed your quote request.
HasSentArtwork=has sent you an artwork.
HasSentInvoice=has sent you an Invoice - Invoice
HasSentPurchaseOrder=has sent you a purchase order.
HasSentQuoteRequest={0} has sent you a quote request for {1}
MediaBookingNumber=Media Booking Number
NoAvailableSuppliersSelected=No available suppliers selected.
NumberOnly=Number Only
OrderReady=OrderReady
PackageIsNullPleaseCheck=The package is null; please check the setting of template or package.
PleaseWaitHiResArtwork=Please wait while your Hi-Res artwork is being sent to your supplier...
PleaseWaitOrderBeingProcessed=Please wait while your order is being processed...
PositionalDiagram=Positional Diagram
QuoteQuantity=Quote Quantity
QuoteRequestResult=Quote Request Result
ReadyToOrder=Ready to Order
ReadyToSend=Ready to Send
RequestedDate=Requested Date
RequestedQuantity=Requested Quantity
RequestHasBeenAcceptedBy=Your quote has been accepted by {0}
RequestHasBeenCancelledBy=The request has been canceled by {0}
RequestQuotes=Request Quotes
RequestsSent=Requests Sent
ResponsedDate=Responsed Date
SelectQuantityGetFinalPrice=Please select the Quantity to get the Final Price.
SelectSuppliersToSendQuoteRequest=Please select the supplier(s) you wish to send a quote request to.
SendToPublication=Send to Publication
SendToSendlite=Send to Sendlite
SubmitQuote=Submit Quote
SuccessfullyResponsedWithPrice=You have successfully responded with price.
SupplierQuoteRequest=Supplier Quote Request
SureOrderWithThisSupplier=Are you sure you want to Order with this supplier?
SureSendRequestToSelectedSupplier=Are you sure you want to send request to selected suppliers?
UploadingError=Uploading error. Please retry.
ViewAndDownloadArtwork=view and download artwork
ViewAndRespond=view and respond
ViewOrderConfirmationOnline=view your order confirmation online
ViewTheRequest=view the request
YouHaveResponsedWithPrice=You have already responded with price.
SendQuoteRequest=Send Quote Request
EnterEmailForOtherSupplier=Please enter Email address when you choose another supplier.
