AddGuest=ゲストを追加
AddGuestNames=ゲスト名を入力してください。
Age=年齢
AreYouSure=続けてもよろしいですか？
Birthday=生年月日
Branch=支店
BranchCode=支店コード
BriefIsBeingReviewed=ブリーフ確認中です。
Circle=サークル
ClearGlossVinyl=透明なグロスビニール
ClearSynthetic=透明な合成品
ClearSyntheticElectrostatic=透明な合成静電容量
Client=顧客
Contact=連絡先
CustomQuoteRequest=カスタマイズの見積もり依頼
CustomSize=カスタムサイズ
DeclinedReason=却下理由
DescriptionAtLeast200Characters=説明には少なくとも200文字が必要です。
DieShape=Die Shape
DownloadQRCode=QRコードをダウンロード
DownloadVideo=ビデオをダウンロード
EnsureRelevantToImages=説明は選択した画像に関連することを確認してください。
EnterBranchCode=支店コードを入力してください。
EnterBranchCodeToRegister=登録するには支店コードを入力してください。
EnterDetailsForRegistration=詳細を入力して登録してください。
FillInConfirmPassword=確認パスワードを入力してください。
FillInDescription=説明を入力してください。
FillInFirstName=名前を入力してください。
FillInLastName=名字を入力してください。
FillInNameAgePhoto=名前、年齢、プロファイル写真を入力してください。
FillInPassword=パスワードを入力してください。
FillInPropertyAddress=物件の住所を入力してください。
FillInPropertyCityOrSuburb=物件は都市情報選択してください。
FillInPropertyPostcode=物件の郵便番号を入力してください。
FillInValidEmail=有効なメールアドレスを入力してください。
GlossPaper=光沢紙
Guest=ゲスト
InfoSetting=情報設定
IntroImage=オープニングの画像
IntroVoiceOver=オープニングのナレーション
InvalidEmailAndPassword=無効なメールとパスワード
IsPrinted=印刷されていますか？
LabelQuoteRequest=ラベルの見積り依頼
LastNameIsMandatory=名字は必須項目です。
MandatoryFields=必須項目
NarrowEdge=低い幅
NotAvailable={0}は使用できません。
NotReady='{0}'の準備ができていません。管理者に連絡してください。
OutroImage=エンディングの画像
OutroVoiceOver=エンディングのナレーション
Oval=長円形
PaperWithBlockOutDarkLayer=遮光紙（黒）
PaperWithBlockOutSilverLayer=遮光紙（シルバー）
PiggybackPaperOnPaper=Piggyback Paper on paper
PrintedOneSide=片面印刷
PrintedTwoSides=両面印刷
QRCode=QRコード
QuoteQTY=料を見積もる
Rectangle=長方形
Reference=基準
RegisteredSuccessfully=登録が正常に完了しました。
Registration=登録
RemovableClearSynthetic=取り外し可能な透明合成品
RemovableGlossPaper=取り外し可能な光沢紙
RepositionableGlossPaper=再配置可能な光沢紙
ResubmitVideo=ビデオを再送信
SettingInfo=情報を設定する
SomethingWrongWithVideoOrder=ビデオの注文にエラーが検知されました。
Step1=ステップ１：システムへの登録
Step5YourBriefReviewed=ステップ５：ブリーフを確認中です
Step5YourVideoProduced=ステップ５：ビデオを作成中です
Step6VideoIsReady=ステップ６：ビデオが完了しました
Stock=株
SubmitAComplaint=完成したビデオが注文内容と異なる場合、訴状を提出してください。
SubmitComplaint=訴状を提出
SubsiteNotConfigured=ビデオ注文のサブサイトがまだ設定されていません。トップスナップまでご連絡ください。
TargetMarketCustomer=ターゲット市場・顧客
UncoatedPaper=コーティングしていない紙
Unique=ユニーク
UniqueSellingPointsWowFactor=ユニークなセールスポイント
UnPrinted=印刷中止
Upload8Images=少なくとも8画像をアップロードしてください。
UploadAndSave=アップロードして保存
UploadCompanyLogoForIntro=オープニングに使用する会社ロゴをアップロードしてください。
UploadCompanyLogoForOutro=エンディングに使用する会社ロゴをアップロードしてください。
UploadedImages=アップロードされた画像
UploadFile=ファイルをアップロード
UserDetails=ユーザ情報
VideoFinish=ビデオ完成
VideoIsBeingProduced=ビデオを作成中です。準備ができましたら、メールでお知らせいたします。
VideoIsReady=ビデオが完成しました。
VideoIsReady1=ビデオが完成しました。ご確認のほどよろしくお願い致します。
VideoOrderDeclined=ビデオの注文が却下されました。
VideoRequestDeclined=ビデオの依頼が却下されました。
VideoTemplateNotFound=ビデオのテンプレートが見つかりません。トップスナップまでご連絡ください。
VideoURL=ビデオのURL
VideoWaitingToBeReviewed=確認待ちのビデオがあります。
WeWillContactYou=ブリーフを確認しています。問題がなければ48時間以内でビデオが作成されます。不明点がありましたら、またお客様にご連絡させて頂きます。
WeWillEmaiIt=ビデオは48時間以内で作成されます。準備ができましたら、メールでお知らせいたします。
WideEdge=高い幅
DescriptionCount=説明（200文字以上） - カウント
EnsureIncludeInDescription=必ず説明に含めてください。
ToneThemeOfTheProperty=プロパティのトーン/テーマ
VideoVoiceOver=ビデオの声が上に提供される説明をオフに基づいて行われます
Minimum200=最小200文字は説明のために必要。
PropertyDetails=物件の詳細
SalesAuctionDate=販売日
Step3LogIntoSystem=ステップ３：システムにログインします
UploadCompanyLogo=会社のロゴと画像をアップロードして、物件の詳細を入力してください。
VideoForm=ビデオ申請書