ChangePassword=Change password
ChangePasswordForm=Change Password Form
ConfirmNewPassword=Confirm New Password
CreateAccount=Create an account
CurrentPassword=Current Password
DoNotHaveAccount=Don't have an account yet?
Email=Email
EnterPasswordAndEmail=Please enter your email and password to log in.
ErrorCheck=You have some form errors. Please check below.
ForgotPassword=I forgot my password
KeepSignedIn=Keep me signed in
Login=Login
MinimumLengthForPassword=The {0} must be at least {2} characters long.
NewPassword=New Password
NewPasswordConfirmationPasswordDoNoMatch=The new password and confirmation password do not match.
Password=Password
SignInAccount=Sign in to your account
TitleOfLogin=VCM {YODA} Login - Beta
UserNamePasswordIncorrect=The user name or password provided is incorrect.
UseUpToDateVersion=Please use the most up-to-date version of your browser:
AuthenticationReturnError=The authentication provider returned an error. Please verify your entry and try again. If the problem persists, please contact your system administrator.
EmailExist=A user name for that e-mail address already exists. Please enter a different e-mail address.
EmailInvaild=The e-mail address provided is invalid. Please check the value and try again.
InvalidAccess=Invalid Access
LoginRemoved=The external login was removed.
PasswordChanged=Your password has been changed.
PasswordIncorrect=The current password is incorrect or the new password is invalid.
PasswordInvalid=The password provided is invalid. Please enter a valid password value.
PasswordRetrievalAnswerInvalid=The password retrieval answer provided is invalid. Please check the value and try again.
PasswordRetrivalQuestionInvalid=The password retrieval question provided is invalid. Please check the value and try again.
PasswordSet=Your password has been set.
RequestCanceled=The user creation request has been canceled. Please verify your entry and try again. If the problem persists, please contact your system administrator.
UnknownError=An unknown error occurred. Please verify your entry and try again. If the problem persists, please contact your system administrator.
UserNameExist=Unable to create local account. An account with the name \\"{0}\\" may already exist.
UserNameExist1=User name already exists. Please enter a different user name.
UserNameInvalid=The user name provided is invalid. Please check the value and try again.
ChameleonVCMLogin=PrintUI VCM Login
CurrentOrNewPasswordInvalid=The current password is incorrect or the new password is invalid.
EnterEmailToResetPassword=Enter your e-mail address below to reset your password.
ErrorAndCheck=You have some form errors. Please check below.
FillInEmail=Please fill in email address.
FillInPassword=Please fill in password
FillInValidEmail=Please fill in a valid email
ForgotPassword1=Forgot Password?
IllegalAccess=Illegal Access
NewPasswordFilled=New password should be filled.
NotAvailable={0} is not available
NoUserNameUnderSubsite=There is no user with this user name under this subsite
NoUserUnderSubsite=There is no user under this subsite
ResetPassword=Reset your password
ResetPasswordTokenExpired=Reset Password token has expired. Password is not changed.
SignInByEmail=Sign in by Email
SignInByUserName=Sign in by User Name
ImpersonateUser=Impersonate User
Impersonating=Impersonating
ListOfSubsites=List of Subsites
ListOfUsers=List of Users
UserNameContains=User Name contains
ChooseSubsite=Please choose a subsite
Impersonate=Impersonate
InputUserName=Please input user name
StopImpersonating=Stop Impersonating
