AddBudget=予算を追加
Admin=管理者
AfterHours=勤務時間後
Announcements=お知らせ
BoardingRequest=オンボーディング要求が{0}件あります。
BoardingSites=オンボーディングのサイトが{0}件あります。
BudgetMustBeNumeric=予算は数値で入力する必要があります。
BudgetReport=予算報告
By=により
CartsApprovedOrRejected=承認または却下されたカートが{0}点。
CartsWaitingForApproval=承認待ちのカートが{0}点。
Contact=連絡先
ContinueWithoutSelectProperty=物件を選択せずに続行
Dashboard=ダッシュボード
HomePage=ホームページ
InfoForStep1=公開サイトを\r\n右上のメニューにあるサブサイト管理から選択
InfoForStep2=左のメニューからサイトを選択して管理します。各ページに説明が記載されます。
InformationForStep1=まずは、会社の詳細を入力して、本社のサイトを作成します。
InformationForStep2=次に支店やその他の店舗のサブサイトを作成します。
InformationForStep3=最後に公開サイトの左メニューに表示するカテゴリを設定します。
InformationForStep4=画面のプロンプトに従い、サイトを作成する手順を実行してください。
JobsApprovedOrRejected=承認または却下されたジョブが{0}点あります。
JobsWaitingForApproval=承認待ちのジョブが{0}点あります。
Main=メイン
ManageSite=既存のサイトの管理方法
ModifyTemplateToJumpStart=ASP.NETのMVCアプリケーションを起動するためにテンプレートを修正します。
NewsList=ニュースの一覧
NewsListPage= NewsListPage
NotSelected=未選択
PropertyDetails=物件の詳細
QuickHelp=不明点がありましたら、クイックヘルプをクリックしてください。
RejectedOriginalAsset=却下されたオリジナルアセット
RequestForOriginalAsset=オリジナルアセットのアップロードリクエスト
RequestWaitingForApproval=オリジナルアセットの承認待ちリクエスト
SelectAnotherProperty=別の物件を選択
SelectedSitename=選択したサイト名：
SelectProperty=物件を選択
SetUpSite=新規サイトを構築する方法
Step1=ステップ1：
Step2=ステップ2：
Step3=ステップ3：
Step4=ステップ4：
TitleOfAdmin=管理者画面のダッシュボード
Updates=更新情報
UserHasNotAssigned=ユーザにまだサイトが割り当てられていません。システム管理者にご連絡ください。
ViewMore=続きを見る
WelcomeToAdmin=管理者画面へようこそ
CampaignReport=キャンペーン報告
LoginToSalesForce=画像をダウンロードするには、まずSalesforceにログインしてください。
NoImagesFound=画像が見つかりませんでした。
OrderReport=注文報告
PleaseSelectProperty=物件を選択してください。
ResultOf=結果
ResultsFor=の結果
SearchForPropertyAddress=物件の住所を検索
SearchImages=画像を検索
SearchResultImage=画像の検索結果
TemplateReport=テンプレートレポート