AddEditRateCard=価格表を追加・編集
AddRateCard=価格表を追加
AddSupplier=サプライヤーを追加
AvailableDays=利用可能日時
BulkDownloadRatecardsSuccessfully=価格表のCSVダウンロードが正常に完了しました。
BulkUploadFailed=バッチアップロードが失敗しました。CSVファイルの形式を確認してください。
BulkUploadRatecard=価格表のCSVアップロード
BulkUploadRatecardsSuccessfully=価格表のCSVアップロードが正常に完了しました。
DeliveryCost=配送費用
DownloadSuppliersToCSVFile=サプライヤーをCSVファイルにダウンロード
DownloadToCSVFile=CSVファイルにダウンロード
EmailCCList=CCリストにメールを送信
EmailExist=メールアドレスは既に存在します。別のメールアドレスを入力してください。
EnableFTP=FTPを有効にする
ExtraCost=追加費用
FillInSupplierName=サプライヤー名を入力してください。
FTPHost=FTPホスト
FTPPassword=FTPパスワード
FTPUsername=FTPユーザ名
LinageSettingAndDetails=系統の設定と詳細
LineageAvailability=利用可能曜日
LineageSection=セクション
MediaBooking=広告スペース予約
MediaBookingSection=セクション
MediaBookingSize=サイズ
MediaContactSetting=設定
MISType=MIS型
NameEmailContains=名前またはメールに含まれます
RateCardId=価格表のID
RateCardName=価格表の名前
SelectMediaContactType=メディアコンタクトの種類を選択
SelectSupplierRole=サプライヤーの役割を選択してください。
SendliteEnabled=Sendliteが有効になりました
SendliteOrderUrl=Sendlite注文のURL
SendliteSettingUrl=Sendlite設定及びURL
SendliteStatusUrl=SendliteステータスのURL
SendliteSubscriberNumber=Sendlite登録番号
SetupCost=設置費用
SupplierAddPage= SupplierAddPage
SupplierFTPSetting=サプライヤーのFTP設定
SupplierList=サプライヤーの一覧
SupplierListPage= SupplierListPage
SupplierName=サプライヤ名
UpdateRateCard=価格表を更新
UploadCSVFile=CSVファイルをアップロードしてください。
AddNewRateCard=新規価格表を追加
Bleed=ブリード
BulkUploadRatecard1=価格表のCSVアップロード
EditRateCard=価格表を編集
ExistingSupplierFound=サプライヤーは既に存在します。
Price=価格
RateCardBulkUpload=価格表のCSVアップロード
RateCards=価格表
SelectMediaType=メディアタイプを選択
SupplierEditPage= SupplierEditPage
SupplierEmail=サプライヤーのメール
SupplierPhone=サプライヤーの電話
SupplierRateCard=サプライヤーの価格表
SupplierRateCardPage= SupplierRateCardPage
SupplierRoles=サプライヤーの役割
SureDelete=削除してもよろしいですか？
UpdateSupplier=サプライヤーを更新
CSVFile=CSVファイル
SupplierSelectSiteErrorPage= SupplierSelectSiteErrorPage
HOWTOAddSuppliers=サプライヤーの追加方法
HowToSetUpSupplier=サプライヤーの設定方法
MediaContact=メディアコンタクト：出版物
PrintContact=プリントコンタクト：価格表の登録や注文書の送信などの権限を持つサプライヤー
RegisteringAccreditedSuppliers=許可したサプライヤーを事前にサイトに登録すると、直接注文することができます。
Sendlite=Sendlite：第三者のメディアサプライヤー
Step1=ステップ1：サプライヤーの連絡先を入力します。
Step2=ステップ2：サプライヤーの役割を設定します。
Step3=ステップ3：該当する場合は、FTPを設定します。
DaysBefore=Day(s) Before
MaterialDate=Material Date